好马不吃回头草	a good man doesn't backtrack
小菜一碟	a piece of cake
太阳从西边出来	hell freezes over
说曹操，曹操到	speak of the devil
乌鸦嘴	jinx
二百五	halfwit, pea-brain
吃一堑，长一智	a fall in the pit, a gain in your wit
睁着眼睛说瞎话	to flout reality, to tell bald-faced lies, to lie through one's teeth
近朱者赤，近墨者黑	one is marked by the company one keeps
物以稀为贵	that which is rare is dear
王婆卖瓜，自卖自夸	every potter praises his own pot
站着说话不腰疼	talk is cheap, to be an armchair quarterback
天下没有不散的筵席	all good things must come to an end
天上掉馅饼	to have something fall into your lap
巧己所不欲，勿施于人	do unto others as you would have them do unto you
睁眼瞎	a bad judge of character
跳进黄河洗不清	to be unable to clear one's name
拍马屁	to suck up to, curry favor, ingratiate
情人眼里出西施	love is blind, beauty is in the eye of the beholder
打酱油	I couldn't care less, that's above my pay grade
不怕一万，就怕万一	one can never be too careful
走着瞧	wait and see
不管三七二十一	to act recklessly, to throw caution to the wind
吃着碗里的，看着锅里的	to be unsatisfied with what one has
钻牛角尖	to split hairs, to go down a dead end
人不可貌相，海水不可斗量	you can't judge a book by its cover
林子大了，什么鸟都有	there are all kinds of fish in the sea
鸡毛蒜皮	trivial, trivalities
鲜花插在牛粪上	a beautiful woman is married to an old/ugly man
醉翁之意不在酒	to have an ulterior motive
猴年马月	god know when, it'll be a cold day in hell when
眼不见为净	what somebody doesn't know/see can't hurt them
姜是老的竦	with experience comes wisdom
得青山在，不怕没柴烧	where's there's life there's hope
拿得起，放得下	to be able to go with the flow
以其人之道还治其人之身	to give someone a taste of their own medicine, to pay back in one's own coin
走桃花运	lucky in love
成事不足，败事有余	incompetent, everything one touches turns to dust
皇上不急太监急	the person involved is calm and collected but observers are very worried
三个臭皮匠，顶个诸葛亮	two heads are better than one
脚踩两只船	to have a foot in both camps
此地无银三白两	telltale sign, methinks the lady doth protest too much
吃不到葡萄就说葡萄酸	sour grapes
心急吃不了热豆腐	more haste less speed
家常便饭	run of the mill, par for the course
癞蛤蟆想吃天鹅肉	to be out of one's league, to want to punch above one's weight
天无绝人之路	there is always a way out
走后门	get in through the back door
瞎猫碰上死耗子	even a broken clock is right twice a day
好汉不吃眼前亏	discretion is the better part of valor, you have to know when to hold'em and when to fold'em
解铃还须系铃人	he that hides can find
肥水不流外人田	one does not allow benefits created by one's own work to accrue to others
心有余而力不足	run out of steam
不分青红皂白	indiscriminate
睁一只眼，闭一只眼	to turn a blind eye
破罐子破摔	a vicious cycle
种瓜得瓜，种豆得豆	you reap what you sow
萝卜白菜，各有所爱	different strokes for different folks
狗嘴里吐不出象牙	what can you expect from a hog but a grunt
三天打鱼，两天晒网	to blow hot and cold, lack perserverance and continuity
一朝被蛇咬，十年怕井绳	once bitten twice shy
英雄难过美人关	no man can resist the charms of a beautiful woman
刀子嘴，豆腐心	to be a softie at hear, someone's bark is worse than their bite
一失足成千古恨	one false step brings everlasting grief
哪壶不开提哪壶	rub someone's nose in it
炒鱿鱼	to can someone, to give someone a pink slip
人往高处走，水往低处流	it is in man's nature to strive for better
说得比唱得好听	to speak eloquently but untruthfully
强扭的瓜不甜	you can lead a horse to water but you can't make him drink
老掉牙	tired old
搬起石头砸自己的脚	to shoot oneself in the foot
卖关子	to leave someone hanging
一分钱一分货	you get what you pay for
九牛二虎之力	a Herculean effort
敬酒不吃吃罚酒	to acquiesce to something after having refused someone's first overture
躲得过初一，躲不过十五	you can't avoid something forever, you can't keep something up forever
吃香的，喝辣的	to live in the lap of luxury
小儿科	child's play, easy
一个巴掌拍不响	it takes two to tango
牛头不对马嘴	incongrous, neither here not there
以小人之心，度君子之腹	to project one's shortcomings on someone
车到山前必有路	we'll cross that bridge when we come to it
鸡蛋里挑骨头	to nitpick, to find quarrel in a straw
吃不了兜着走	to be unable to bear the consequences of failure
打肿脸充胖子	to puff oneself up at one's own cost
三十六计走为上	to get out while the going's good
当耳旁风	to roll off like water off a duck's back
恨铁不成钢	expect better from someone
你走你的阳关道，我过我的独木桥	let's go our separate ways
过了这个村，就没这个店	it's now or never, opportunity seldom knocks twice
抱佛脚	to cram, fair weather atheists turn to god in a pinch
有钱能使鬼推磨	money talks
有其父必有其子	like father like son, the apple doesn't fall far from the tree
不见棺材不落泪	to hold out hope until faced with the grim reality
三长两短	god forbid anything should happen to someone
纸包不住火	the truth always comes out, there is no concealing the truth
好戏在后头	the best is yet to come, you ain't seen nothing yet
吹牛皮	brag, to blow smoke
欲速则不达	more haste less speed
家家有本难念的经	we all have our burdens to bear, every family has its hardships
墙头草	fence sitter
替罪羊	sacrificial lamb, scapegoat
近水楼台先得月	to enjoy the benefits of a favorable position
小巫见大巫	to pale in comparison with, doesn't hold a candle to
过河拆桥	to kick someone to the curb when they've outlived their usefulness.
一不做，二不休	in for a penny in for a pound
以牙还牙，以眼还眼跑了	an eye for an eye and a tooth for a tooth
和尚跑不了庙	you can run but you can't hide
绿帽子	cuckold
识时务者为俊杰	he who understands the times is a wise man
井水不犯河水	to stay in one's own lane,mine one's own business
一棵树上吊死	to be inflexible and stubborn
放鸽子	to stand someone up, to leave someone in the lurch
一步一个脚印	to take something one step at a time
上梁不正下梁歪	a crooked stick will have a crooked shadow
不入虎穴，焉得虎子	nothing good comes without risk
赔了夫人又折兵	to suffer a double loss
有心栽花花不长，无心插柳柳成荫	to unknowingly benefit from an unexpected course of events
八字还没一撇	it hasn't even begun
有眼不识泰山	to entertain angels unawares, to fail to recognize a formidable/famous person
出气筒	punching bag
八九不离十	close to the mark, not far off
无风不起浪	there's no smoke without fire
得便宜卖乖	to not admit that one has received a benefit
不是省油的灯	a real piece of work
家丑不可外扬	don't wash dirty linen in public
背黑锅	to take the rap, to take the blame, be left holding the bag
兔子不吃寓边草	even a villain doesn't harm the next door neighbors
铁饭碗	a cradle-to-grave job
冰冻三尺，非一日之寒	Rome wasn't built in a day
远亲不如近邻	better a close neighbor than a distant brother
下马威	opening gambit, take someone a notch down, establishing an imposing air or advantageous position for oneself
天下乌鸦一般黑	they're all the same
不到黄河心不死	it's not over 'til it's over
狗急了跳墙	despair fives courage even to a coward
狗眼看人低	to have one's nose in the air, to be stuck-up
只许州官放火，不许百姓点灯	one may steal a horse while another may not look over a hedge
偷鸡摸狗	to pilfer, to philander
死马当活马医	to make a Hail Mary effort
新官上任三把火	to make drastic changes to an organization upon taking charge
对号入座	to make a connection
十万八千里	worlds apart
露马脚	to let the cat out of the bag
公说公有理，婆说婆有理	each side believes it is correct, both sides have their merits
上刀山，下火海	come hell or high water
打退堂鼓	to beat a retreat
磨刀不误砍柴工	a beard lathered is half shaved
风马牛不相及	as different night and day, to be as different as chalk and cheese
一山不容二虎	two tigers cannot share one mountain
里揉不得沙子	to not let things slide
三下五除二	in no time (flat),deftly
泼冷水	to pour cold water on
杀鸡给猴看	to throw the book at someone to set an example
生米做成熟饭	the die is cast, what's done is done
初生牛犊不怕虎	youth knows no fear
铁公鸡	miser, tightwad
无事不登三宝殿	one never visits unless they need something
马后炮	to be wise after the fact
掉链子	to fumble the ball
纸老虎	paper tiger
狐狸精	vixen, siren
丑话说在前头	let's be candid here, let's get the unpleasant/unpleasantness out of the way
半路杀出个程咬金	someone threw a wrench in the works
麻雀虽小，五脏俱全	even if something is small it can still contain the essentials
虎毒不食子	even a monster would not hurt its own children
小不忍则乱大谋	a little impatience will spoil great plans
打狗还得看主人	every action has consequences, when one beats a dog one must answer to its master
万事俱备，只欠东风	to be prepared but lack the crucial element
不管黑猫白猫，会捉老鼠就是好猫	it does not matter whether a cat is black or white so long as it catches mice
真金不怕火炼	true blue will never stain
狗改不了吃屎	the fox may grow grew but never good
杀手锏	ace in the hole, trump card
饥不择食	beggars can't be choosers
对事不对人	it's nothing personal
皮笑肉不笑	fake smile
双刃剑	double-edged sword
热脸貼冷屁股	to have someone not give you the time of day
好了伤疤忘了疼	once on shore one prays no more
醋坛子	jealous lover
君子之交淡如水	the friendship between gentlemen appears indifferent but is pure like water
三个和尚没水吃	everybody's business is nobody's business
赶鸭子上架	to force someone to put a square peg into a round hole
小白脸	pretty boy
放长线，钓大鱼	to play the long game
依葫芦画瓢	to follow suit
隔墙有耳	walls have ears
巧妇难为无米之炊	you can't make bricks without straws
不是吃素的	to be someone not to be trifled with
嫁鸡随鸡，嫁狗随狗	a woman should stand by her man
打开天窗说亮话	to lay one's cards on the table
人算不如天算	the best laid plans of mice and men often go awry, man proposes god disposes
小动作	a cheap shot, a cheap trick
远水解不了近渴	while the grass grows the horse starves
占着茅坑不拉屎	to be a dog in the manger
碰一鼻子灰	to get the cold shoulder, to be left out in the cold
死猪不怕开水烫	the situation is already so bad that to make it worse makes no real difference
换汤不换药	putting old wine in new bottles
救命稻草	a straw to clutch at
明枪易躲，暗箭难防	better an open enemy than a false friend, an open foe may prove a curse but a pretend friend is even worse
谋事在人，成事在天	man proposes god diparesis's all in god's hands now
三个女人一台戏	three women make a market four a fair
有鼻子有眼	a word picture, a vivid description
枪打出头鸟	the hunter will shoot the bird that sticks out
碰钉子	to be rebuffed
蹬鼻子上脸	to go too far
吃豆腐	to take advantage of a woman
眉毛胡子一把抓	to tackle everything all at once, to deal with everything in one fell swoop
偷鸡不成反蚀把米	to go out for wool and come back shorn
众人拾柴火焰高	little things add up, many hands make light work
快刀斩乱麻	to cut the Gordian knot
吃软饭	freeloader, to freeload
一着不慎，满盘皆输	one false move may lose the game
听风就是雨	to jump to conclusions from insignificant evidence
鸿门宴	ambush, treacherous plot
吃哑巴亏	to bite one's tongue, to hold one's tongue
眼中钉、肉中刺	a thorn in the side
舍不得孩子套不住狼	you have to spend money to make money
挂羊头、卖狗肉	to bait and switch, to cry wine and sell vinegar
煮熟的甲鸟子飞了	to slip though one's fingers
常在河边走，哪有不湿鞋	touch pitch and you shall be defiled
三脚猫	dilettantish, middling
吃闭门羹	to be left out in the cold, to get the cold shoulder
三十年河东，三十年河西	change is the only constant, the wheel of fortune turns
土包子	bumpkin, boor, hillbilly
树大招风	the winds howl around the highest peaks
酒逢知己千杯少	for a good friend a thousand toasts are too few
当一天和尚撞一天钟	to go through the motions
是骡子是马拉出来遛遛	actions speak louder than words, it's time to see what someone is worth
一个鼻孔出气	to be hand in glove
身在曹营心在汉	to not have one's heart in something
瘦死的骆驼比马大	a starving camel is still bigger than a horse
树欲静而风不止	for a situation to takes it own course regardless of someone's wishes
丑媳妇早晚也得见公婆	one is unable to avoid an unpleasant experience forever
胜者王侯败者贼	winning isn't everything it's the only thing, history is written by the victors
下三烂	low-life, low-down
上了贼船	to get in too deep, to cross the Rubicon
病急乱投医	desperate times call for desperate measures, a drowning man will clutch at a straw
打如意算盘	to engage in wishful thinking
龙生龙，凤生凤	like father like son, like mother like daughter
不看僧面看佛面	for someone's sake
雷声大、雨点小	all talk no action
脸红脖子粗	flushed with excitement/agitation, to be red in the face
一棍子打死	to throw the baby out with the bathwater
拿鸡蛋碰石头	to pick a losing battle
没有不透风的墙	two may keep counsel putting one away
人怕出名猪怕壮	fame can be a double-edged sword
山中无老虎，猴子称大王	when the cat's away the mice will play
杀鸡焉用宰牛刀	you don't need a sledgehammer to crack a nut
大树底下好乘凉	follow closely behind heavy-laden wagons
跑龙套	to be a small player, act as a utility man
七大姑，趴大姨	extremely distant relatives
一是一，二十二	to call a spade a spade
多个朋友多条路	the more friends you have the more options you have in life
下台阶	to give someone an out
打小算盘	to act in one's own self-interest
坐山观虎	sit this one out and reap the spoils later
斗羊毛出在羊身上	there's no such thing as a free lunch
一口吃成个胖子	to wave a magic wand and get what one wants
屋漏偏逢连阴雨	when it rains it pours
老油条	wily old fox, slippery one
捅马蜂窝	to stir up a hornet's nest
小意思	not a big deal, a token
倒打一耙	to play the blame game
陈芝麻，烂谷子	idle chatter
一条龙	from soup to nuts
四两拨千斤	to solve a big issue with little effort
前怕狼，后怕虎	to be afraid to commit oneself
吃水不忘挖井人	when drinking water don't forget those who dug the well
有仇不报非君子	a real man must settle his scores
不倒翁	a tumbler
干打雷，不下雨	to talk the talk but not walk the walk, all bark and no bite
鸡飞狗跳	in a tizzy
事后诸葛亮	hindsight is 20-20
落水狗	one who is down on their luck
板上钉钉	a sure bet, a shoo-in
一碗水端平	to be impartial, to take an impartial approach
烫手的山芋	a hot potato
笑掉大牙	to laugh one's head off
一回生，二回熟	a stranger is just a friend you haven't met yet
鱼与熊掌不可得兼	one can't have everything in life
咸鱼翻身	to give a new lease on life
一根绳上的蚂蚱	to be in something together
趟浑水	to intentionally get involved in a messy situation
狗腿子	lackey, henchman, lapdog
用在刀刃上	to employ limited resources where they are needed most
鸡飞蛋打	to come up empty-handed
胳膊扭不过大腿	the weak cannot contend with the strong
饱汉不知饿汉饥	the wearer knows best where the shoe pinches
笑面虎	a wolf in sheep's clothing
二	clueless
给力	awesome, exciting
母老虎	shrew
五十步笑百步	the pot calling the kettle black
门外汉	a layman
前人栽树，后人乘凉	for posterity's sake, walnuts and pears you plant for your heirs
烂泥扶不上墙	to wash a pig is to waste both water and soap
关公面前耍大刀	to teach one's grandmother how to suck eggs
高不成，低不就	to not be good enough to get what one wants but unwilling to pursue something befitting one's talents
胳膊肘往外扭	to side with outsiders instead of one's own people
长痛不如短痛	it's better to deal with painful things quickly, it's better to just rip the Band-Aid off now
酒香不怕巷子深	good wine needs no bush
一条路走到黑	to be as stubborn as a mule
不是鱼死，就是网破	it's either him or me
冰山一角	the tip of the iceberg
身体是革命的本钱	good health is a prerequisite for work
说风凉话	to crack wise
紧箍咒	to tug on the yoke, a yoke on the shoulders
唱双簧	a carefully choreographed dance, to scheme with someone
开空白支票	to make a promise one cannot keep, to write a check one can't cash
保护伞	something providing legal or political cover for someone
一个萝卜一个坑	each has his own task and there's nobody to spare
狗咬狗	dogfight
唱高调	to posture
打水漂	to make ducks and drakes of
开小差	to let one's mind wander, to zone out
两面派	double-dealer, double dealing
一盘散沙	to be in state of disunity
和稀泥	to paper over something
敲竹杠	to fleece, highway robbery
扯后腿	to hold someone back
穿小鞋	to stack the deck against someone
给他一点颜色看看	to take someone down a peg, to fix someone's wagon
天高皇帝远	when one is far away from authority the powers that be will not intervene
拣软柿子捏	to pick on an easy target
打马虎眼	to play dumb, to demur
千里马	wunderkind, prodigy
打擦边球	to push the envelope
摸着而头过河	to cross the river by touching stones
半路出家	mid-life career change
老狐狸	sly old fox
一窝蜂	a swarm
开夜车	to burn the midnight oil
手心手背都是肉	a tough call
缩头乌龟	a chicken, a coward, a scaredy cat
走过场	to go through the motions, to do something as a formality
做文章	to seize on, to make an issue of something
吃大锅饭	to be compensated without regard to performance
戴高帽	to oversell something
秋后算账	revenge is a dish best served cold
僧多粥少	too many boats chasing too few fish
坐冷板凳	to be sidelined
不当家不知柴米贵	if one is not in someone else's situation one cannot understand that person's troubles
红眼病	jealousy, the green-eyed monster
葫芦里卖的是什么药	to have something up one's sleeve
三句话不离本行	to hardly be able to talk about anything other than one's work
糖衣炮弹	Trojan Horse
树倒猢狲散	rats leave a sinking ship
硬骨头	a tough nut to crack, one tough cookie
二虎相争，必有一伤	when two tigers clash, one is sure to get hurt
拆东墙，补西墙	to rob Peter to pay Paul
大鱼吃小鱼	the law of the jungle
狐狸尾巴露出来了	to show one's true colors, the jig is up
开绿灯	to give the go-ahead
歪瓜裂枣	a troll
小辫子	chink in one's armor
一头雾水	at a loss
隔行如隔山	different professions are different worlds
一亩三分地	personal fief
成也萧何，败也萧何	one's successes and failures are both due to the same person
大水冲了龙王庙	friendly fire
乱弹琴	to speak or act without sound reason
挤牙膏	to draw something out, to be like pulling teeth
墙倒众人推	everyone kicks a man who is down
莫须有	groundless, trumped-up
拿鸡毛当令箭	to use a made-up directive to order people around
捅破窗户纸	to affirm an open secret, to address the elephant in the room
三字经	curse
苍蝇不叮无缝的蛋	to bring bad things upon oneself as a result of one's bad character
大跌眼镜	to have one's jaw drop, to be slack-jawed
说一千，道一万	there are no two ways about it
绊脚石	stumbling block
过五关、斩六将	to overcome great challenges and have the glory to show for it
求爷爷、告奶奶	to go around begging for help
羡慕嫉妒恨	to be green with envy
打掉门牙往肚里咽	to bite one's tongue
唱对台戏	to steal someone's thunder, to take the wind out of someone's sails
分一杯羹	to take one's share of the loot
变色龙	chameleon
独木不成林	a single tree does not a forest make
既生瑜，何生亮	if god made someone so excellent why did he make someone even better
撂挑子	to quit one's job, to shirk one's responsibilites
敲门砖	prerequisite for
试金石	touchstone, standard or criterion by which something is judged
火烧眉毛	the chips are down, pressing
空手套白狼	to gain something without risking anything of one's own
一瓶子不满，半瓶子晃荡	empty barrels make the most noise
脱了裤子放屁	as useless as tits on a bull
借东风	to ride the wave
白开水	vanilla
鲤鱼跳龙门	to get one's big break, carp jumping the dragon gate, advance to a point at which one's success is guaranteed
强龙压不住地头蛇	you can't beat someone on their home turf
这山望着那山高	the grass is greener on the other side
光脚的不怕穿鞋的	he who is down need fear no fall
不成功，便成仁	to win or die trying
滚刀肉	real piece of work
久病成良医	prolonged illness makes the patient a good doctor
枕边风	pillow talk
一锤子买卖	to skin the sheep
横挑鼻子竖挑眼	to do one's utmost to find the problems where there are none
唱空城计	to bluff, to not be at home
一刀切	cookie-cutter
旧瓶装新酒	new content in an old form
两面三刀	two-faced, double-dealing
一把钥匙开一把锁	there is a key for every lock
打一巴掌，给个甜枣	to throw someone a bone, to use the carrot and stick approach
先君子后小人	let's not let this get ugly
尺有所短，寸有所长	no one is perfect but no one is worthless either
出来混的，总要还的	chickens come home to roost
画虎不成反类犬	(to try to emulate something beyond one's ability and) fall flat on one's face
大意失荆州	to suffer a serious setback as the result of a careless mistake
卸磨杀驴	to kick someone to the curb when they've outlived their usefulness
躺着都中枪	to get caught in the crossfire
脚正不怕鞋歪	an honest man fears no gossip
有奶就是娘	to sell one's allegiance to the highest bidder
肉烂在锅里	it's all in the family
说你胖你就喘	flattery like perfume should be smelled not swallowed
擦屁股	to clean up someone's mess
皇帝女儿不愁嫁	sitting pretty
一朝天子一朝亞	new leaders appoint new counsellors
活人让尿憋死	to not be adaptable
走马灯	incessant turnover of personnel, revolving door, musical chairs
花无白日红	nothing good lasts forever
东风压倒西风	the good guys win
岁月是把杀猪刀	time isn't kind to anyone
丁是丁，卯是卯	to be meticulous
多年的媳妇熬成婆	to have paid one's dues and get what one deserves
强将手下无弱兵	there are no poor soldiers under an able general
头痛医头，脚痛医脚	to slap a Band-Aid on something
拉不出屎来怨茅房	a good carpenter doesn't blame his tools
东方不亮西方亮	while something isn't workable in one place it might be workable somewhere else
老牛拉破车	to trundle along
放卫星	to talk the talk,to talk big
鸡同鸭讲	whistling in the wind
一锅端	to be wiped out all at once
老皇历	anachronistic,old news
家花没有野花香	the grass is always greener (on the other side of the fence)
又想当婊子又想立牌坊	to want to be able to do immortal things while maintaining a good name
遮羞布	a fig leaf
耍花枪	to toy with someone
又要马儿跑，又要马儿不吃草	to have one's cake and eat it too
牛不喝水强按头	to impose one's will on someone
摆乌龙	made a mistake,to put one's foot in it
各打五十大板	to punish both parties equally without considering guilt
一个将军一个令	new lords new laws
抱大腿	to cozy up to someone powerful
砸了锅	to drop the ball
会哭的孩子有奶吃	the squeaky wheel gets the grease,those who complain the loudest get the most attention
二一添作五	go fifty-fifty,to split something down the middle
风一阵，雨一阵	to flit from one thing to another
剃头挑子一头热	not having any of it
远来的和尚会念经	all that is foreign must be better
揪辫子	to seize on someone's shortcomings,to get one's hooks into someone
小姐的身子丫鬟的命	a good lady with bad fortune
只见树木，不见森林	to not see the forest for the trees
屁股决定脑袋	one's position determines one's views and behavior
兔子尾巴长不了	something's days are numbered
骑马找马	to look for another job while keeping one's current position
敲锣边儿	to stir the pot
扣帽子	to paint someone as something,to call someone names
拨出萝卜带出泥	one thing brings about another
满嘴跑火车	to blow smoke,to be full of it
温水煮青蛙	to boil the frog slowly
万金油	panacea,jack of all trades
树挪死，人挪活	people unlike trees thrive on change
按下葫芦起了瓢	to be like Whac-A-Mole
到什么山唱什么歌拔	to change one's tune when talking to different people
根汗毛比腰粗	to be significantly richer or more powerful than others
阎王好见，小鬼难搪	getting past the gatekeeper is the hard part
不见兔子不撒鹰	to not commit oneself until success is certain
当面锣，对面鼓	to has things out in the open
眼大肚子小	to have eyes bigger than one's stomach
浅水养不了大鱼	a big fish needs a big pond
吃别人嚼过的馍不香	if you're not the first you're the last
起大早，赶晚集	first off the blocks but last over the line
打不着狐狸惹身骚	to wake a sleeping giant
多面手	polymath,a renaissance man/woman
鸟枪换炮	to be moving on up
矬子里拔将军	in the land of the blind the one-eyed man is king,the best house in a bad neighborhood,to pick the best out of a bad group
给个棒槌就当针	to take something too literally or seriously
捧臭脚	to lick someone's boots
咬人的狗不露齿	beware of a silent dog and still water
炒冷饭	to rehash
一只羊是赶，一群羊也是放	what's one more
虱子多了不咬，账多了不愁	worry is interest paid on trouble before it is due
攒鸡毛，凑掸子	quantity does not make up for inferior quantity
骑脖子拉屎	to treat someone like garbage
指着和尚骂秃子	thinly veiled criticism
蚂蚱也是肉	a buck is a buck
背着抱着一般沉	six of one half a dozen of the other
一言堂	an area where one person's words goes
乱拳打死老师傅	an inexperienced person defeats a master by throwing out the rules of traditions
端起碗来吃肉，放下筷子骂娘	to drink the ocean and then call it salty
出头的椽子先烂	the nail that sticks out gets hammered down
一马勺坏一锅	one bad apple spoils the barrel
终日打雁，让雁啄了眼	the hunter becomes the hunted
老鸹嫌猪黑	it's the pot calling the kettle black
别人牵驴你拨橛	to get caught holding the bag
仔卖爷田不心疼	to sell one's birthright for a mess of pottage
萝卜快了不洗泥	the hasty bitch brings forth blind puppies
接地气	grounded, down to earth
装逼	posture
牛逼	impressive, awesome
异世	alternate world
太古	primordial
上古	ancient
丈	ten feet
打量	sized up
穿越	transmigrate
紧接着	right on the heels of
放在心上	take it to heart
暗暗恼怒	seething inside
茶杯	teacup
丰满	voluptuous
土豪	whale
土豪	baller
暴发户	nouveau riche
京城	capital
直播	live-stream
总裁	President
夫人	Madam
管家	butler
话里话外	the meaning between the lines
峰回路转	tables have turned
助手	assistant
喜怒无常	temperamental
啪——	Bam—
医药箱	medicine box
亲自过问	take up the matter personally
高高在上	high up in the air
黑白不分	confound right or wrong
小丫头	the little girl
叮咚	Ding-Dong
职业装	business attire
不分青红皂白	did not distinguish right or wrong
在最短的时间内	as soon as possible
出了一身冷汗	broke out in a cold sweat
老夫人	Matriarch
奶奶	Grandma
小婶婶	Young Aunt
小叔叔	Young Uncle
小心肝	little sweetheart
饭桌	dining table
认祖归宗	Acknowledging one's roots and ancestors
孙媳妇	grand daughter-in-law
拿你没办法	don't know what to do with you
茶几	coffee table
多一事不如少一事	it is better to avoid unnecessary trouble
小院	small courtyard
虎头蛇尾	strong start but weak finish
使幺蛾子	make trouble out of nothing
钻石发夹	diamond hair clip
人证物证俱在	human testimony and material evidence
臭小子	Young brat
管家爷爷	Butler Grandpa
热锅上的蚂蚁	a cat on a hot tin roof
寿桃	longevity peach
老爷子	Old Master
祝您福如东海，寿比南山	may your happiness be as immense as the East Sea, and may you live as long as the Zhongnan Mountains
姑姑	Auntie
说时迟那时快	no sooner said than done
宣传	publicity
公关	public relations
员工餐厅	employees' cafeteria
执行报告	execution report
合作案	proposal
休息室	lounge
秘书	secretary
策划部	planning department
内部网	Intranet
手机	cell phone
会客沙发	guest sofa
前台	front desk
接待员	receptionist
值班表	duty roster
讨公道	seek justice
公私分明	to be scrupulous in separating public from private interests
经理	Manager
楼道	corridor
商业场	business industry
展示墙	exhibition wall
集团	Corporation
笔记本电脑	laptop
会客室	guest room
餐厅	cafeteria
主管	supervisor
红烧肉	red braised pork
小本本	notebook
财务处	finance department
妈	Mom
总裁夫人	Mrs President
叶明敏	Ye Mingmin
内线	office line
财务部	finance department
奖金	bonus
工资卡	wage slip
逃过一劫	dodge the bullet
客厅	living room
浴室	bathroom
保姆车	huge van
保镖	bodyguard
鸭舌帽	baseball cap
游乐园	amusement park
煎蛋	sunny-side up
经纪人	manager
孤儿院	orphanage
公关部	public relations department
表姐	Cousin
监控	surveillance cameras
工牌	employment pass
分录	data entry
打印机	printer
代言人	spokesperson
服务员	service staff
大佬	big boss
公益活动	charity event
售票处	ticketing booth
庆功宴	celebration party
会所	clubhouse
包间	private room
房车	camper van
保安	security officer
衣柜	closet
隔间	cubicle
主位	master seat
富二代	rich second-generation heirs
服务员	attendant
餐桌	dining table
公共洗手间	public toilet
真心话大冒险	Truth or Dare
顾名思义	As the name implies
主持人	emcee
司机	chauffeur
新品	new product
发布会	news conference
消息网	information network
大美人	great beauty
定制	custom-made
活动现场	event location
现场	event location
媒体	media
宿舍	dormitory
老顽固	stick-in-the-mud
保时捷	Porsche
滨江大道	Riverside Promenade
方向盘	steering wheel
宾利	Bentley
有名也有实	bona fide
顺其自然	let nature take its course
沈麦格	Shen Mag	hero/train as a cook
艾米	Amy	heroine/cute little girl/Mag's daughter
露娜•菲尔德	Luna Field	a teacher at Chaos School
墨白	Mobai	Mag's neighbor/a blacksmith
莎莉	Sally	an elf
尤利安	Urien	Mag's neighbor/a magic caster
康帝·尼古拉斯	Conti Nicolas	a knight
哈嘣	Habeng	an orc
哈嘎	Haga	an orc
丑小鸭	Ugly Duckling	Amy's cat
普罗尔·木杉	Proll Musan	an owner of a fragrant incense shop
哈里森	Harrison	a very fat man/his family owns three banks
萨格拉斯	Sargeras	a lava demon
克拉苏·艾欧	Krassu Aiou	a magic caster in the Magus Tower
杰尔吉·法兰索瓦	Gjergj Francois	a very fat man/owner of two forges
诺兰大陆	Norland Continent	a big continent
混乱之城	Chaos City	on Norland Continent/where heroes live
亚丁广场	Aden Square	in Chaos City/where heroes live
洛斯帝国	Roth Empire	a powerful country which issued the coin
暮光森林	Twilight Forest	a forest that belongs to orcs
斯塔罗海	Staro Sea	a sea northeast of the Roth Empire
索罗群岛	Soro Islands	in the waters of Staro Sea
风之森林	Wind Forest	a forest that belongs to elves
生命之泉	Spring of Life	belongs to elves
亡灵群岛	Ghost Islands	belongs to demons
维克岭	Vic Mountain	belongs to goblins
艾森铁堡	Issen Castle	dwarves’ habitation
洛丹米尔港	Lordamere Harbor
风之谷	Valley of the Wind	located in the Wind Forest
洛都	Rodu	the capital of the Roth Empire
双塔镇	Town of Two Towers
狂暴雾岛	Frenzy Isle	in the depths of the Ghost Islands
法师塔	Magus Tower	in Rodu/also known as the Serving Tower
富二代	rich second generation
巨龙	giant dragon
恶魔	demon
兽人	orc
精灵	elf
矮人	dwarf
狮鹫骑士	Griffin Rider
魔法师	magic caster
米其林餐厅	Michelin restaurant
天道	God
厨神养成系统	God of Cookery Cultivation System
灶台	cooking bench
巨魔	troll
扬州炒饭	Yangzhou fried rice
吃货	chowhound
厨神试炼场	test field for the God of Cookery
煤气灶	gas stove
侧吸式油烟机	side-suction range hood
十字对开门冰箱	four-door refrigerator
厨房刀架	knife block
中华菜刀	Chinese chef’s knife
锅碗瓢盆	pots and pans
厨具	kitchenware
电器	appliances
白开水	plain boiled water
美食文化	food culture
满汉全席	Manchu Han Imperial Feast
食材	ingredient
公主抱	princess hug
儿童床	crib
爱心早餐	love breakfast
身体素质对照表	strength sheet
经验包	experience bag
色香味	taste, color, aroma
树菇	tree mushroom
冬笋	winter bamboo shoot
青豌豆	green pea
小米葱	green onion
米其林星级餐厅	Michelin starred restaurant
口感	texture
刀工	cutting skills
锅	pot
勺子	ladle
葱花	chopped green onions
锦上添花	make perfection still more perfect
爽口	refreshing
扑鼻而来	tickle your nose
风卷残云	like a whirlwind sweeping away the scattered clouds
衣柜	wardrobe
橱柜	kitchen cupboard
厚片	thick slice
薄片	thin slice
细丝	fine shred
丁	small cube
厨师服	chef's suit
平底鞋	flat shoes
裤袜	pantyhose
淘米	rinse the rice
电饭煲	rice cooker
嫩	young
按顺序	in proper order
烤鹅店	roast goose restaurant
价格清单	price list
银币	silver coin
金币	gold coin
龙币	dragon coin
日照时间	sunshine duration/sunshine hours
海妖	siren
紫纹对虾	purple-striped shrimp
暗影野猪	shadow boar
哥布林	goblin
红鹰	red hawk
凉茶	herbal tea
麦米餐厅	Mamy Restaurant
灰神殿	Gray Temple
蓝紫色	bluish violet
火球术	fireball magic
炎魔	balrog
混乱学园	Chaos School
牛皮	cowhide
野牛皮	bison hide
弗莱尔酒馆	Fryer Tavern
恢复药水	recovery potion
中级恢复药水	middle-grade recovery potion
九九乘法表	nine-nine table
灵果	spirit fruit
箭筒	quiver of arrows
豆腐脑	tofu pudding
弹窗广告	pop-up ad
麦格	Mag
肉夹馍	roujiamo
诺梵	Novan
克拉苏	Krassu
十级	10th-tier
蒸汽机	steam engine
海德尔	Hydle
龟壳师父	Master Turtle
魔法药水铺	magic potion shop
熔岩恶魔	lava demon
爱莎	Aisha
熙熙	Xixi
鹿鹿	Lulu
亚北米娅	Yabemiya
魔法波动	magic waves
世界树	World Tree
德鲁伊	dryads
伊丽莎白	Elizabeth
福克斯	Fox
德沃	Devoe
德沃酒馆	Devoe Tavern
理事	Board Member
马尔斯	Mars
西里尔	Cyril
杰弗里	Jeffree
亚丁商会	Chamber of Commerce
香菇	shiitake mushroom
铜币	copper coins
半胡子师父	Master Half-beard
魔法防护罩	magic shield
燃烧军团	Burning Legion
基尔	Kiel
马克扎	Markza
科苏斯	Cossus
大光头	Big Bald Head
卡尔扎克	Calzac
身体素质点	strength
大砂锅	earthenware pot
厨神	God of Cookery
绿豆	Green Pea
黑炭	Black Coal
巴斯蒂监狱	Bastie Prison
布兰德利大人	Lord Brandli
加百列	Gabriel
黑十字	Black Iron Cross
古迪尼亚	Goodenia
布兰德利	Brandli
乔纳森副典狱长	Deputy-warden Jonathan
法师袍	magician robe
魔法棒	wand
伊琳娜	Irina
海伦娜	Helena
海蒂	Hetty
餐厅	restaurant
骑士	knight
兵器铺	arms shop
荆棘谷	Valley of Thorns
暗影十三式	Thirteen Swordplay Forms
源力	essential energy
战技	battle technique
紫纹狮鹫	purple-striped griffin
剑技	sword techniques
魔兽晶核	beast core
斩	slash
美食排行榜	Delicious Cuisine Rankings
路德	Rood
阿尔文	Arvin
杰尔吉	Gjerj
美食协会	Food Association
法里奥丁	Freuden
大德鲁伊	Great Dryad
暗夜精灵	night elves
冰霜之主	Lord of Ice
流沙世界	Flowing Sand World
美食排行榜	Aden Square food competition
安德鲁	Andrew
柏妮丝	Bernice
达芙妮	Daphne
麻辣烤鱼	spicy grilled fish
极寒之焰	flames of extreme frost
蓝白	bluish white
法术	spell
厨神进阶大转盘	God of Cookery upgrade wheel
乔修	Josh
修斯	Seuss
亚历克斯	Alex
奎因	Quine
肖恩	Sean
西蒙	Simon
王宫	imperial palace
恶龙	wicked dragons
大长老	great elder
大长老	Great Elder
理查德	Richard
狮鹫	griffin
布伦特	Brent
徒弟	disciple
亚瑟	Arthur
艾略	Elliot
多步森	Dobson
乔治	Geroge
餐饮协会	Catering Association
黄焖鸡米饭	braised chicken and rice
里奇	Ricky
马车	horse-drawn carriage
斯坦利	Stanley
沃伦	Warren
会长	president
歌洛璃娅	Gloria
系统	system
凤凰	phoenix
杰西卡	Jessica
哈根达斯	Haagen-Dazs
彩鳞草鱼	iridescent scale grass carp
剑神试炼场	Sword God test field
城主府	city lord's castle
罗伯特	Robert
托尼斯	Tonis
客人	customer
迈克尔	Michael
夏洛克侦探事务所	Sherlock Detective Agency
劳瑞	Lorry
森林巨魔	forest troll
粉条	cellophane noodles
肖纳德	Schonard
薇薇安	Vivian
小姐	Young Mistress
城主	city lord
筷子	chopsticks
伊格纳兹	Ignatsu
月光香米	moonlight rice
麦纳德	Manard
蒙德	Mond
小胡子哥哥	Big Brother Mustache
火焰之神	Lord of Fire
冰霜巨龙	Frost Dragon
黛蓝布艺店	Blue Suede Textiles Shop
希尔	Scheer
巴菲特	Buffett
姬恩	Jean
极乐净土	Gokuraku Jodo
姐姐	Big Sister
姐姐	big sister
帕默	Parmer
帕博尔	Parber
安格斯	Angus
迪克斯	Dicus
丽贝卡	Rebecca
瓦尔克	Warrick
长剑	longsword
骑士公会	Knight Association
伍德罗	Woodrow
巴拉巴拉爷爷	Grandpa Blah Blah
音乐盒	music box
柜台	counter
盖伊	Guy
小豆芽	Little Bean Sprout
米兰达	Miranda
香草	vanilla
抹茶	mocha
蓝莓	blueberry
巧克力	chocolate
冰激凌	ice cream
布卢尔	Blour
布鲁斯特	Brewster
金克斯	Jinx
德古拉	Dracula
海维德	Havid
古斯塔夫	Gustav
塔卢斯	Tauros
恶魔群岛	Demon Islands
无尽海域	Boundless Sea Realm
白吉馍	bai ji bread
芬妮	Fanny
英格威	Yngwie
大祭司	High Priestess
帝国高级学院	Advanced Imperial Academy
梦幻紫国	purple dream kingdom
卡帕斯	Karpas
如意魔法棒	Queen Amy's wand
脑域	brain realm
艾伯特	Abbott
斯纳尔	Snarr
克罗尔	Krol
休伯特	Schubert
贝比利	Baibilly
通灵之门	omniscient door
格雅旅店	Geya Hotel
雪莉尔	Shirley
康斯坦丁	Constantine
露娜	Luna
星海	Sea of Stars
埃比尼泽	Ebenezer
特里	Terry
约书亚	Joshua
安娜	Anna
冰火爆爆弹	Ice Fire Bomb
生命之乳	milk of life
棱刺战猪	porcupine battle boar
中级魔法	intermediate spell
铁皮蛮牛	Ironhide Bull
魔兽	magic beast
迷雾谷	Illusionary Mist Valley
宰牛刀	bull-slaying blade
紫金貂	Purple Golden Mink
蔷薇佣兵团	Rose Mercenary Squad
纳尔逊	Narson
比尔特利	Bertley
兰克斯特	Rankster
芭芭拉	Babla
凯罗尔	Cayrols
自行车	bicycle
菲丽丝	Firis
生命之树	Tree of Life
阳台	balcony
水灵珠	Water Spirit Jewel
火灵莲花	Fire Spirit Lotus
红顶三花鸭	Red-top Tricolor Ducks
亚伯罕	Abraham
克丽丝	Christy
克莉丝	Christy
卡洛丝	Carla
the Marquis Family	马奎斯家族
the Moreton Family	莫尔顿家族
Bart	巴特
Bowen	波文
希维尔	Sivir
牛头恶魔丹尼斯	minotaur demon Dennis
伊娃	Eva
斯考特	Scott
西德尼	Sydney
斯克罗	Skol
巨人峡谷	Giant Canyon
回力标	boomerang
缚灵绳	spirit binding rope
眼光扫过	eyes flicked from face to face
目光扫过	eyes flicked from face to face
舔了一下嘴唇	tongue flicked across his lips
瞟了	flick a glance at
瞥了	flick a glance at
眼睛一下子	eyes flicked open
认真	gravely
面色剧变	face was dark with anger
剧变	voice thick with anger
剧变	face was tight with anger.
剧变	mouth twisted in anger
剧变	mouth tightened in anger
奇怪	looked at her strangely
古怪	looked at her strangely
空间	distort space
好吃	heavenly, devine,exquisite,finger-licking good
悬崖边	dangled from the cliff edge
典型	quintessential
偶然	serendipity
机缘巧合	serendipity
运气	serendipity
豪华	opulent
奢华	opulent
富丽堂皇	opulent
娴静	demure
端庄	demure
矜持	demure
请客	It's on me. I got this one.
老鼠屎	a few bad apples spoil the bunch
请客	this is my treat
辛苦了	I appreciate your help. thank you for working hard.
太难了	life is so hard. I'm so dead. it's all just too much.
目光呆滞	stare blankly
几分	a note of desperation in his voice
语气	a note of desperation in his voice
几分	He had a grim cast to his grey eyes this day
带有	He had a grim cast to his grey eyes this day
几分	Valyrian steel had a darkness to it
有点	Valyrian steel had a darkness to it
几分	a hint of sadness in his voice
有点	a hint of sadness in his voice
有些	a nervous edge to his voice
怨气	an edge of bitterness
几分	spoke to him, timidly and cautiously.
三分	spoke to him, timidly and cautiously.
茫然	stared unseeingly at
发愣	stared unseeingly at
呆呆	stared unseeingly at
呆滞	stared unseeingly at
心不在焉	stared unseeingly at
几分	added significance and beauty to the night
添加	added significance and beauty to the night
增加	added significance and beauty to the night
面色	went white
面色	wide-eyed
本性	an ineradicable part of their natures
惊呼	cry
惊叫	cry
干了	drained her glass
添满	filled up her glass
怒火中烧	seething
怒火	seething
闷气	seething
气呼呼	seething
主意	had designs on
不轨	harbor evil intentions
不怀好意	harbor evil intentions
不知不觉	drifted into sleep
趴	head down on the desk
温柔	soften
关心	with concern
关怀	with concern
暖暖	warm feeling in her heart
温暖	a warm feeling in his heart
处理	process
忙	have my hands full
厨师服	chef's uniform
蹑手蹑脚	creep
限	Limit one per customer
外带	no to go allowed
剧变	redden
休想	He was damned if he would
死也不会	He was damned if he would
一时	In an excess of enthusiasm
酗酒	drinking to excess
怪	fault
指责	fault
闭关	went into seclusion
伯格	Borg
斗志	fight
画面	paint a picture of
画面	draw this picture
问题是	just a question of
抱抱	quick hug
豆腐渣	inexpensively made
恩将仇报	don't bite the hand that feeds you
左右两侧	guards to his left and right
纹章	crest
徽章	crest
解除	break the reanimation jutsu
齐射	barrage
全盛期	in your glory days
洗手不干	washed her hands of
脱离	washed her hands of
连锁反应	ripple effect
蝴蝶效应	ripple effect
焦躁	restless and unsettled
不安	restless and unsettled
怀疑	have serious reservations
魔法	there is spellwork on this wall
涉足	dabbles in
订做	a bespoke suit
定做	a bespoke suit
神魂颠倒	dazzled by
来买	step right up
来看	step right up
方圆	anything inside of 20 feet will be ash
范围内	anything inside of 20 feet will be ash
半径	anything inside of 20 feet will be ash
直径	anything inside of 20 feet will be ash
在逃	on the lam
赞扬	To his credit
痛心	heart wrenching
心痛	heart wrenching
鲜明	was in stark contrast to
表现	come off well
狂	party animal, party hound
物业费	homeowners association fee
一会	catch up with you guys later
避开	short-circuit
模糊	shaky
一次	at once
油水	rich pickings to be had
值了	My life is complete
别急	All in good time
不要紧	that's fine
没事	that's fine
炫耀	flex
问题	go pear-shaped
脱口而出	rattle off
不假思索	rattle off
轻松	rattle off
美味	scrumptious
好吃	scrumptious
刺鼻	tangy
难闻	tangy
胃口	hearty appetite
品味	refined palate
解除	undo the spell
骄傲自大	fall prey to hubris
冷血	I don't do feelings.
研究	read up on the case
消除	erase your memory
得体	overstep the bounds of propriety
过去的	past me
回头	check back with me
自我保护	some sense of self-preservation
排挤	squeeze out
挤垮	squeeze out
实惠	cost effective
性价比	cost effective
影响	fallout
后果	fallout
生意	deal with
讨厌鬼	creep
铭牌	name tag
抵消	counteract
买	spring for
中年	middle-aged
懒洋洋	languid
无精打采	languid
满是	guilt-ridden
内疚	guilt-ridden
鱼香茄子	the eggplant with garlic sauce
豆瓣酱	chili broad bean paste
葱	spring onions
甜面酱	sweet bean sauce
金属盖	cloche
刀工	knife skills
黄瓜	cucumber
北京烤鸭	Peking Duck
三花鸭	Red-top Tricolor Ducks
结结巴巴	halting
期待	expectantly, with anticipation, expectant
期待	hopefully
杜卡斯	Ducas Restaurant
希瑞尔	Hiril
老巴菲特	Ian
臭豆腐	stinky tofu
维森尼奥	Vicennio
黑胡椒牛排	pepper steak
烤鱼	grilled fish
小车	dining cart
烤鹅坊	Roast Goose Restaurant
空间魔法师	spatial magic caster
巅峰	in top form
家长会	parent-teacher meeting
德鲁	Drue
夏佐	Shaza
邦妮	Bonnie
班主任	homeroom teacher
约瑟夫	Joseph
贡献奖	Outstanding Contribution Award
毕维斯	Bevis
教导主任	school administrator
教导主任	director of guidance
迪恩	Dene
征服	captivate
瞪	give him a hard look
口水	set his mouth to watering
油	dripped with grease
迫不及待	eagerly
怂	break first
齐声	said as one
怒	face was tight with anger
打量	appraising
许多	multitude
一下子	all at once
美食排行榜	food competition
老爷	Master
布雷尔	Bourell
布莱尔	Bourell
戴里克	Derrick
素食主义者	vegetarian
素菜	vegetarian food
鱼香茄子	eggplant with garlic sauce
矮人铁匠	dwarf blacksmith
乔恩	Chown
乔森	Jenson
极寒领域	cold domain
浩海园	secondary section
青芽园	primary section
汉米敦	Hamilton
米娅	Miya
好为人师	Interfering Teacher
机车	locomotive
巴菲特钱庄	Buffett Bank
财团	conglomerate
地精	goblin
总工程师	Chief Engineer
威压	aura
八级	8th-tier
小老板	Little Boss
臭龙龙	Stupid dragon
火球	fireball
小鬼	little brat
奎林娜	Quilina
约翰斯	Johns
霸王餐	dine and dash
法师杖	magic caster's staff
宝箱	treasure chest
五级	5th-tier
小老板	Little Boss
小杂种	little half-breed
近战魔法	Close combat magic
远攻魔法	far offensive magic
风火轮	wind fire wheels
麦老板	Boss Mag
红龙族	red dragon tribe
龙族	dragon tribe
红龙岛	Red Dragon Island
半精灵	half-elf
禁锢魔法	imprisonment spell
龙岛	Dragon Island
烈焰猪	Fiery Pig
火龙岛	Fire Dragon Island
四级	4th-tier
荒野	wilderness
佣兵	mercenaries
九级	9th-tier
工作人员	staff member
龙岛群岛	Archipelago
火龙族	Fire Dragon Tribe
宿主	the host
阿紫	Ah Zi
世界警察	world's policeman
美食系统	cuisine system
意外所得税	windfall tax
第五峰	Fifth Peak
大棚	greenhouse
保险柜	safe
市场规律	market rules
职业操守	professional ethics
大象食呗	Elephantpay
叮！	Ding!
新任务发布	New mission
任务成功奖励	Mission reward
任务失败	Mission failed
第五峰	5th Peak
夜明珠	Luminous pearl
藏宝库	treasure vault
冰霜战场	Frost Battlefield
七级	7th-tier
道格拉斯	Douglas
冰霜龙源	Frost Dragon Source
望远镜	telescope
屠龙勇士	dragon killer
悬空岛	hovering islands
串烤	kebab
烤架	grill
族长	chief
大殿	hall
年轻一代	younger generation
皇族	royal family
偷袭	sneak attack
杂种	half-breed
五长老	Fifth Elder
七长老	Seventh Elder
二长老	Second Elder
决斗	battle
恭送	farewell
父亲大人	Father
七雷轰顶	Seven Thunder Strikes
少爷	Young Master
蒂莫西	Timothy
诺亚·古德尔	Noya Gould
精神力	spiritual power
诺亚	Noya
卡萨丁	Kassadin
石林	stone forest
殿下	Your Highness
黑衣人	man in black
公主	Princess
精灵女王	elf queen
智囊团	think tank
亡灵气息	Ghost's Aura
生命之神	God of Life
高级魔法师	advanced magic casters
雷闪	Thunderflash
战技	combat technique
高阶骑士	high-tier knight
金牌会员	Gold Member
承诺书	letter of commitment
金卡	gold card
大魔法师	great magic caster
爆裂火球	Exploding Fireball
山间小道	small mountain path
魔法书	spell book
巴泽尔	Barzel
贝克·巴泽尔	Beck Barzel
寻人启事	missing-person notice
贝亚特	Beate
艾维斯	Avis
瑞德餐厅	Reid Restaurant
烤乳猪	roast pig
副主厨	sous chef
毕尔曼	Bellmann
瑞德	Reid
铁匠	blacksmith
哈达	Hada
黛蓝	Blue Suede
黛蓝服饰	Blue Suede Fashion
服装店	Clothing store
班杰明	Benjamin
瑞秋	Rachel
辛迪娜	Cynthia
师父	Master
魔法屏	magical screen
披风	cape
鳞片	scale
音爆	isonic boom
嗷呜	Howl
坐骑	ride
高台	elevated platform
医疗箱	medical box
小米	Amy baby	only when Mag refers to Amy. If Amy is referring to herself, it is just Amy
冰锥	icicle
畅享券	buffet coupon
伊夫力	Everley
人贩子	human traffickers
治疗魔法	healing magic
秘书长	chief secretary
雏菊行动	Operation Daisy
罗兰殿主	Lord Rolan
城主令	city lord's order
兔子精	rabbit spirit
小白兔	Little Rabbit
人贩	human traffickers
灰胖胖叔叔	Uncle Gray Fatty
三毛叔叔	Uncle Three Hair
塞西尔	Cecil
黄金巨龙	Golden Dragon
师傅	Master
女装大佬	drag queen
月之国	moon nation
祭坛	altar
巫师	sorcerer
无上的神	Supreme God
铠甲	armor
黑袍人	man in black robe
姬娜	Gina
兰蒂斯特	Lantisde
大巫师	Great Sorcerer
空中花园	sky garden
飞行魔兽	flying magic beast
S计划	Plan S
莫尔顿	Moreton
卡米拉	Camilla
庄园	Manor
小黑	Little Black
兰斯	Lance
黛布拉	Debra
米基	Mickey
伯爵夫人	Countess
吸血鬼	vampire
S级	S grade
防空导弹	air defense missiles
巴托里	Bartoli
龙源	dragon source
半龙人	half-dragon
石屋	stone hut
躺椅	lounge chair
紫砂	purple sand
小本子	notebook
柯蒂斯	Curtis
凯尔	Kyle
蝙蝠干	dried bats
黛米服饰	Demi Fashion
爱国者	Patriots
红旗	Red Flag
风衣	trench coat
大祭司	High Priest
神选之人	Chosen One
传送阵	teleportation portal
能源石	power stone
传送石	teleportation stone
鱼人	Merfolk	Merman/mermaid for a single
哥哥	big brother
魅魔	succubus	succubi for plural
黄泥烤鸡	mud-covered roast chicken
叫花鸡	beggar's chicken
叫化鸡	beggar's chicken
厨神进阶大转盘	God of Cookery upgrade wheel
二级	2nd-tier
尤金	Eugene
富宾恩	Fabian
美人鱼	mermaid
浴缸	bathtub
死库水	school swimsuit
水手服	sailor dress
鱼缸	fish tank
荷叶	lotus leaf
三黄鸡	Three Yellow Chicken
塔塔里沙漠	Tatari Desert
圣地	Holy Land
安戈洛峡谷	Angolo Canyon
死亡之地	Land of Death
微博	Weibo
豆芽菜姐姐	Big Sister Bean Sprout
麦格先生	Mr. Mag
相煎何太急	why harm each other in such haste
母后	Queen mother
古训	old teachings
副会长	Vice President
兰蒂斯特人	Lantisdean
中华菜刀	chinese cleaver
生命之火	Flame of Life
十多年	10-odd years
唐	Don
陶碗	terracotta bowl
黑	black
波顿	Bolton
汤羹榜	soup rankings
肉食榜	meat category rankings
西斯酒楼	Sith Restaurant
河鲜汤	freshwater seafood soup
大人	Lord
烤鸡	roast chicken
狼人	werewolf
兽人兄弟	orc brothers
泥壳	mud casing
霸道总裁	Dominant CEO
圣女	holy maiden
美食界	culinary world
水产	seafood rankings
素食	vegetarian food rankings
小吃	snacks rankings
爆炒小河虾	stir-fried small river prawns
迪卡	Dica
黄焖鸡汤	Braised chicken soup
醍醐灌顶	to enlighten people with perfect wisdom
大王	King
大傻	Dasha
二傻	Ersha
牛头恶魔	minotaur demon
黑猫仆人	black cat servant
棒槌	bludgeon
大元帅	Grand Marshal
安德烈	Andre
死老头	old fart
垃圾桶	trash can
情书	love letter
情敌	love rival
元帅	Marshal
抖M	masochist
抖S	Sadist
班森	Benson
虚空	spatial
族	race
高手	expert
罗兰	Rolan
蒸汽机车	steam train
璃龙	Glass Dragon
混乱之城三巨头	great magic caster trio of Chaos City
情报所	Information Center
亚历克斯大人	Master Alex
家族制	family system
渔民	fishermen
河鲜	freshwater seafood
地窟	crypt
彩虹炒饭	rainbow fried rice
大陆	continent
地窟	underground cavern
神启	revelation
魔法阵	magic spell formation
磁悬浮列	mag-lev
悬浮阵法	anti-gravitational magic spell formation
反重力魔法阵	anti-gravitational magic spell formation
凯森	Kayson
无尽之海	Boundless Sea
考比尔	Colby
神器	amazing machine
一级	1st-tier
侍女	servant
精灵公主	elf princess
反叛军	rebellion army
狼牙棒	mace
胖子	Fatty
瘦子	Skinny
骷髅	skeleton
绍兴酒坛	Shaoxing Wine urn
百米佛跳墙	Buddha Jumps Over the 100-meter-Wall
干鲍	dried abalone
海参	sea cucumbers
鱼唇	shark's lips
花菇	shiitake mushroom
鸽子蛋	pigeon's eggs
鱼翅	shark's fins
厨神进阶抽奖	God of Cookery lucky draw
汤锅	soup pot
油条豆浆套餐	Youtiao and soybean milk set meal
凯撒	Caesar
幽冥漩涡	Nether Vortex
佛跳墙	'Buddha Jumps Over the Wall'
幽冥鲨	Nether Shark
漩涡	vortex
深海渔场	demersal fishing ground
避难所	sanctuary
地下城堡	subterranean castle
幽冥旋风	Nether Whirlwind
幽冥狂潮	Nether Frenzy
弗雷尔小镇	Verell Town
月牙鱼	Crescent Fish
杜尔	Dewell
巴特勒斯	Bulters
弗雷尔	Verell
布洛克	Bulloch
空间戒指	space magic ring
空间手镯	space magic bracelet
风刃	wind blade
三叉戟	trident
石斑鱼	grouper
诅咒之墙	Cursed Wall
伊沃城	Ivo City
神药	Miracle Drug
六级	6th-tier
生鱼片	sashimi
德克斯特	Dexter
卡托尔	Katol
潜艇	submarine
蛟龙号	Jiaolong
同声传译	simultaneous interpretation
通用语	common tongue
神灵阁下	Esteemed Spirit
卡莉	Kelly
大祭师	High Priest
守备队	garrison
阵法	spell formation
巴特勒叔叔	Uncle Bulters
洛克城	Bulloch City
镇长	Mayor
声波墙	ultrasonic walls
磁场球	magnetic interference ball
避水空间	hydrophobous space
人鱼族战士	merwarrior
诅咒屏障	cursed barrier
人鱼爷爷	Grandpa Merman
领域	domain
刀气	saber projection
避水珠	hydrophobic crystal
哈尔杂志社	Hall Magazine Press
杰诺	Geno
总编	Chief
食林	Food Forest
肉食主义	Meatatarianism
素食主义	Vegetarianism
杂志	magazine
杂志社	magazine press
编辑	editor
经销商	distributor
副主编	deputy editor
温妮莎	Vanessa
洛拉	Lola
哈罗德	Harold
哈德罗	Harold
桃瑞斯	Doris
凯西	Kathy
马修	Matthew
马修医生	Dr. Matthew
豆浆	soybean milk
油条	youtiao
留影石	Photostone
基金会	foundation
露娜老师	Teacher Luna
声波球	ultrasonic ball
人鱼	merfolk
陛下	Your Majesty
鲍鱼	abalone
孜然	cumin
狱警	prison guard
雷克斯	Rex
狱卒	prison guard
无发行者	Hairless Monk
半魔人	half-demon
无法行者	Lawless Monk
魔法禁制	magical restraint
说书人	Storyteller
卡尔	Carl
乔纳森	Jonathan
卫斯理	Wisely
典狱长	Warden
强者	powerhouse
海鲜	seafood
龙鳞	dragon scale
返祖	reversion
殿主	Lord of the Gray Temple
卡托鲁	Catoru
史莱族	Sly Tribe
传送魔法	teleportation
亚当斯	Adams
三级	3rd-tier
低阶骑士	low-tier knight
古德尔	Gould
查尔尼	Charney
三年之约	three-year agreement
中级	mid-tier
年终大会	year-end celebration
翼展	wingspan
九阴白骨爪	Nine Yin Skeleton Claw
鲜血沙拉	fresh blood salad
凉拌心脏片	cold tossed sliced hearts
指刀	finger-knives
皮蛋	century egg
黑暗料理	dark cuisine
皮蛋瘦肉粥	congee with pork and century egg
老杰克	Old Jack
西德卡	Sidka
负责人	person-in-charge
萨总	Chief Sargeras
牛皮纸	kraft paper
卡绒鸭	Karon ducks
晨光湖	Morning Lake
生命之水	Spring of Life
道奇	Dodges
清洁工	cleaner
好人卡	'Good Person Card'
许愿机会	Wishing Chance
挑战书	Letter of Challenge
西斯	Sith
光头	bald
挑战	challenge
里奇烤肉店	Ricky's Rotisserie
菲彼	Febid
虚弱叔叔	Mr. Feeble
厨艺对决	culinary duel
老约瑟	Old Joseph
坎迪斯	Candice
兰迪	Randy
坎迪斯	Candice
四大家族	four major families
剑气	sword projection
剑气化光	Light of the Sword Projection
十年之约	ten-year-agreement
墩子	chopper
碱	alkali
茶叶	tea leaves
桑木灰	mulberry ash
料水	pickling solution
干泥粉	dry mud powder
砻糠	rice chaff
爱尔顿	Elton
爷爷	grandpa
参数	parameters
图纸	blueprint
傻大个	Big Orc
生发大师	Master of Hair Growth
克里斯	Crease
关爱头发日	Hair Care Day
列夫	Lev
剁椒鱼头	Steamed Fish Head with Diced Hot Red Peppers
商会	Chamber of Commerce
马奎斯	Marquis
波文	Bowen
胖头鱼	fat head fish
豉油	soy sauce
姜	ginger
蒜	garlic
暗夜精灵	Night Elves
锻造师	weaponsmith
戈达拉	Godala
罗姆大师	Master Rom
罗姆	Rom
天都剑	Tian Du sword
塔姆旅馆	Tam Inn
哈登	Hadeng
烹调女王	Queen of the Culinary
烹饪女王	Queen of the Culinary
菜刀	cleaver
朝天椒	Chaotian Pepper
剁椒	chopped chilli
鱼头	fish head
米粉	rice vermicelli
酒囊	botas de vino
乔伊	Joey
乔斯	Joss
酒馆	tavern
锻造台	forging table
抛物线	parabola
铁臂苍鹰	Iron-Arm Eagle
广罗工作介绍所	Find All Job-Finding Service
鸟巢叔叔	Mr. Nest
和平日	Peace Day
艾许莉	Ashley
康妮	Connie
冰系魔法	ice magic
高级顾问	senior consultant
密室	secret chamber
猫耳	kitten-eared
暮光森林	Twilight Forest
鸳鸯火锅	Double-flavor hot pot
火锅	hot pot
外卖	delivery
骑手	rider
洗发水	shampoo
冲锋衣	technical jacket
熟客	regular
玛菲娅	Maffia
珠宝店	jewellery store
打包	takeaway
希亚珠宝	Shia Jewelley
洁癖	mysophobia
幸灾乐祸	schadenfreude
凯丽	Callie
副典狱长	Deputy Warden
麦格厨师	Chef Mag
御膳房	Royal Kitchen
塔塔里	Tatari
统帅	Chief Commander
尤里	Yuri
小笨蛋	little fool
小霸王帮	Little Tyrant Gang
兰蔻	Lancome
左使	Left Emissary
外卖配送员	Takeaway courier
反弹冰镜	Rebound Ice Mirror
小霸王	Little Tyrants
法克	Falk
黛比	Debbie
盖理	Gary
祖母	grandmother
酋长	chief
奥格	Aug
穿云箭	soaring arrow
猎猫	Nimravidae
麻辣火锅	spicy hot pot
花椒	Sichuan Pepper
火锅专区	designated hot pot area
艾米大姐大	Big Boss Amy
塔魔森林	Tamore Forest
饱了吗	"Are You Full"
车夫	coachman
毛肚	Tripe
牛肚	tripe
鸭肠	duck intestine
指南	manual
肥牛	sliced beef
猪脑	Pig's brain
藕片	Sliced lotus root
金针菇	Enoki mushroom
佳洁士	Crest
龋齿	cavities
长期性异常腐蚀	abnormal case of long-term decay
温莎	Vansa	Vanessa's name incognito
漏勺	slotted ladle
龋齿	caries
星空洞府	The Starry Cave
云南白药	Yunnan Baiyao
文艺晚会	variety show
飞鱼	flying fish
叔叔	Uncle
副殿主	deputy lord
味蕾	taste bud
修炼功法	cultivation methods
玉牌	jade tablet
功法	cultivation methods
小姐	Miss
变态辣	insanely spicy
红汤	red soup base
小胖子	Little Fatty
杀手	assassin
蘸碟	dipping sauce
九宫格	nine-squared pot
令牌	tablet
姗姗	Shanshan
亚麻色	flaxen
瑞娜	Rena
锅中锅	pot in a pot
国王	king
王后	queen
餐车	trolley
国师	royal instructor
空间石	spatial stone
副官	adjutant
驯兽师	beastmaster
白头鹰	white-head eagle
同志	comrade
护卫队	garrison
光之神	God of Light
星空	starry sky
近战	melee
水系魔法	water-type magic
光系魔法	light-type magic
光之毁灭	Light's Destruction
西装暴徒	thugs in suits
西装	suit
圣光	Holy Light
骨翅巨虎	Skeletal-Wing Tiger
移动餐厅	Mobile Restaurant
地精族长	Goblin Chief
月之国	Moon Nation
神秘人	mysterious people
和谈	negotiation
星域	Star Domain
死神	God of Death
环游任务线	roaming mission series
火鸟	flaming bird
星空领域	Starry Sky Domain
侍卫长	Captain
飞行餐厅	flying restaurant
黑雾	black fog
死亡气息	death aura
媳妇	wife
食人恶魔族	Ogres
水幕	water shield
小瓷瓶	little porcelain bottle
生命乳液	Life's Lotion
生命之力	Life Force
小主	little mistress
豆芽菜	Bean Sprout
飞行器	aircraft
母亲大人	Mother
厨师长	Head Chef
租赁公司	rental company
房源	listings
厂房	factory building
猫耳娘	kitten-eared woman
小蝙蝠	Little Bat
车间	workshop
员工宿舍	employees' dormitory
面试	interview
名单	name list
面试者	interviewee
汉娜	Hannah
大叔	Mister
老板娘	lady boss
调料	condiment
香料	spice
干辣椒	dried chilli
八角	star anise
匕首	dagger
纺织工厂	textile factory
纺织机	textile machine
施工队	construction team
深渊恶魔族	abyss demon
石殿	stone temple
烈焰族	flaming tribe
虚空老祖	spatial demon patriach
卡琳丝	Clarince
包工头	contractor
伊米	Imy
工厂	factory
屠龙勇士	dragon slayer
后勤	logistics
火锅女王	Queen of the Hot Pot
铜皮野牛	Ironhide Bull
金贝野猪	Kimball Boar
龙虾	lobster
龙虾养殖基地	lobster rearing base
三大准则	three major principles
小龙虾	crayfish
魔鬼虾	Devil Prawn
超级魔鬼小龙虾	Super Devil Crayfish
隔离网	separation net
麻辣小龙虾	spicy crayfish
蒜蓉小龙虾	garlic crayfish
清蒸小龙虾	steamed crayfish
冰镇小龙虾	chilled crayfish
母亲	Mother
准则	principle
红糖姜茶	molasses and ginger tea
姜茶	ginger tea
红糖	molasses
红糖	molasses
生活用品	life necessities
增压系统	pressurization system
微辣	mild spicy
闹钟	alarm clock
火系魔法	fire magic
水滴状	droplet-shaped
小龙虾养殖基地	crayfish rearing base
生活区	living area
中控室	control room
深渊岛	Abyss Island
阿尔弗雷德	Alfred
无人机	drone
魔鬼	devil
深渊领主	ruler of the abyss
石像	stone statue
烈焰恶魔	Flaming Demon
烈焰岛	Flaming Island
深渊盛宴	Abyss Banquet
三头恶魔犬	three-headed demon hound
深渊毒虫	Abyss Noxious Insects
生命气息	life aura
生命魔法	life magic
光之女神	Goddess of Light
生命女神	Goddess of Life
骷髅头	skull
骨王	Bone King
骷髅人	skeleton man
亡灵大军	Army of the Dead
甲壳岛	Carapace Island
宿主	Host
菜谱	recipe
二锅头	Erguotou
虾虾	shrimpy
虾黄	crayfish butter
龙虾	crayfish
十大恶魔	Top Ten Demon Tribes
巴尔坦恶魔	Baltan Demon
梦魔	Night-mare
龙虾馆	crayfish restaurant
小艾	Ay
鬼面鱼	Ghost-face Fish
深海蛇鳗	Abyssal Snake Eel
塔克	Tuck
巴达	Bada
护身牌	protective amulet
靓仔	Handsome boy
贝壳房	seashell house
贝壳	seashell
木牌	wooden plaque
哈迪斯	Hades
钳子	pincers
钳子	pincers
低调	low profile
伊凡	Ivan
吉米娜	Gemina
岩石巨魔	rock troll
大海龟	giant turtle
贾斯汀	Justin
海龟	turtle
烧烤	barbecue
伊娜	Ina
炖海龟	turtle stew
石头拌沙子	Rocks Tossed with Sand
亡灵之神	God of the Dead
飞行坐骑	flying steed
紧急任务	Emergency Mission
基地守护者	Guardian of the Base
油焖小龙虾	braised crayfish
艾伊小龙虾馆	Ayi Crayfish Restaurant
女恶魔	demoness
护身符	protective amulet
基塔尔	Kitar
独角	unicorn
简	Jane
少女	maiden
粉丝	bean vermicelli
蒜蓉	minced garlic
十王殿	Ten Kings Palace
铁甲恶魔	Armored Demon
小金角	Goldihorn
咋舌	speechless
安吉拉	Angela
魅惑之眸	Eyes of Enchantment
钳	pincer
双面恶魔	two-faced demon
虚空恶魔	spatial demon
低级	low-tier
西蒙斯	Simmons
熔岩岛	Lava Island
沙琳	Charlene
鬼母恶魔	Imp Mother Demon
主战派	pro-war factions
杀手小艾	Ay the Assassin
西角岛	West Point Island
独角恶魔	Unicorn Demon
治疗圣光	Healing Holy Light
光系恶魔	Light-type demon
圣光术	Holy Light Technique
木雕	wood carving
种虾	reproductive crayfish
破坏魔	Shivarra
老板	boss
安吉拉·奥斯特	Angela Austell
神圣白莲	Holy White Lotus
白莲	white lotus
十三香	Thirteen-spice
十三香小龙虾	Thirteen-spice crayfish
王守义	Wang Shouyi
史蒂夫	Steve
皮皮虾王	King Mantis Shrimp
皮皮岛	Phi Phi Island
托尼	Tony
专栏作者	columnist
烤猪蹄	roast pork trotters
食全食美	Perfect Food
火山岛	Volcano Island
火山辣椒	volcanic chili
穆迪	Moody
熔岩圣火令	Holy Lava Order
陨落星辰	Falling Stars
熔岩池	lava pond
恐惧恶魔	Fear Demon
赶海	beach comb
学徒	apprentice
父亲	Father
猫和老鼠	Tom and Jerry
平板	tablet
自动防御	automatic defence
亡灵之力	Power of the Dead
烈火鸟	Flamingo
始祖	ancestor
诺克	Noak
诺希斯	Noxis
梅纳德	Maynard
令牌	amulet
机密库	secret vault
克鲁苏神话	Cthulhu Mythos
H.P.洛夫克拉夫特	H.P Lovecraft
死灵之书	Necronomicon
克鲁苏	Cthulhu
威斯汀	Westin
巴希尔	Bashir
海域	territorial waters
三头鸟	three-headed bird
恐惧群岛	Fear Islands
破坏岛	Shivarra Island
垃圾分类	waste sorting
深渊恶魔	Abyss Demon
外交恶魔	diplomatic demon
岩石岛	Rock Island
始祖血脉	Ancestor Bloodline
贾尔斯	Giles
邪能岛	Fel Island
恐惧恶魔岛	Fear Islands
邪能恶魔	Fel Demon
徽章	emblem
流浪精灵	wandering elves
恐惧岛	Fear Islands
球形闪电	lightning orb
乌贼	squid
老祖	patriarch
恐惧老祖	Fear Demon Patriarch
和谈	peace negotiation
霸主	overlord
海鸥	seagull
宴会厅	banquet hall
栏杆	railing
绿萝	Devil's Ivy
米娅姐	Big Sister Miya
羽绒服	down jacket
朋友圈	WeChat Moments
朋友圈	timeline
菜籽油	rapeseed oil
卡琳丝太太	Mrs. Clarince
榴莲披萨	durian pizza
自然魔法	nature magic
榴莲	durian
猫山王	musang king
待定	pending
榴莲群岛	Durian Islands
揉面机	kneading machine
大臣	courtier
生菜	lettuce
联军	allied forces
纺纱机	spinning machine
工作台	work bench
院子	yard
榴莲推广大使	Durian Popularization Ambassador
高级菜	high-end dish
称号	title
素菜	vegetarian dish
布莱尔总工	Chief Bourell
工程师	engineer
巴菲特酒庄	Buffett Winery
科技	technology
托马斯	Tomas
托尼老师	Master Tony
12寸	12-inch
6寸	6-inch
美食杂志	gourmet magazine
火种	tinder
加封大典	conferring ceremony
文森特	Vincent
婚约	betrothal
生命广场	Life Square
自由	freedom
地牢	dungeon
八大家族	eight major families
三少爷	third young master
狼烟	smoke beacon
广场	square
流星陨落	Falling Stars
厨房	kitchen
金刚狼	Wolverine
法克部落	Falk Tribe
酋长	chief
哥哥	brother
高阶菜谱	top tier recipe
大转盘	wheel
夫妻肺片	Sliced Beef and Ox Tongue in Chilli Sauce	Transliteration: husband and wife lung slice
川菜	Sichuan Cuisine
汤普森	Thomson
卡西斯	Cassis
海螺	conch
元气大伤	one's constitution [vitality] is greatly undermined
父皇	Royal Father
会长室	President's office
加冕仪式	conferring ceremony
机器	machine
锅炉房	boiler room
蒸汽锅炉	steam boiler
烟囱	chimney
棉絮	cotton wool
棉纱	cotton yarn
喵	meow
冰激凌蛋糕	ice cream cake
凯莉	Kelly
绅士联盟	Gentlemen's League
哈威	Harvey
家族	Family
头盔	helmet
唐斯尔	Downsell
教皇	pope
宴会	banquet
罗伊	Roy
萝莉控	lolicon
混乱之城四少	Four Young Masters of Chaos City
萝莉	lolita
人道毁灭	euthanize
巡检司队员	inspector
伊恩	Ian
巡检司	inspector
佣兵工会	mercenary union
卡特拉	Cartera
绅士排行榜	Board of Gentlemen
卡斯特	Caster
绅士积分榜	board of gentlemen
不赞同	disagree
弃权	abstain
赞同	agree
绅士	gentlemen
契布曼	Chapman
哈瑞士	Harris
不败厨神	Invincible God of Cookery
克洛	Klaur
加冕宴会	coronation banquet
小克洛	Klaury
高脚椅	barstool
随缘	let it be
混乱早报	Chaos Morning Post
留音石	Audiostone
大师	Master
名师天赋点	Talented Teacher Point
点石为金	Midas Touch
红茶	black tea
混乱日报	Chaos Morning Post
牛车	bullock cart
装逼	flexing
诺梵校长	Principal Novan
凉菜	cold dish
小友	young friend
试炼场	test field
陶罐	earthenware pot
菜刀	chef's knife
哈瑞士大师	Master Harris
秋刀鱼	Saury
菜板	chopping block
土豆	potato
菜板	cutting board
菜墩	cutting board
积木	building block
十八少女裙	18-Year-Old Maiden's Dress
夫妻肺片	Husband And Wife Lung Slice
魔法室	magic rooms
师兄	Senior
牛舌	ox tongue
牛心	ox heart
牛头皮	ox scalp
牛肉	beef
高压锅	pressure-cooker
压力锅	pressure-cooker
牛杂	beef offal
三奈	galanga
调料	seasoning
下意识	instinctively
下意识	subconsciously
中辣	Medium spicy
红油	red oil
牛骨酸汤	Sour Beef Bone Broth
太师父	Grandmaster
小辣椒	chili padi
生发汤	Hair-Growing Soup
赌场	casino
赌券	betting coupon
银票	banknote
荷官	croupier
超辣	super spicy
比其尔	Bircher
赌坊	gambling den
烤肉店	roasted meat restaurant
班纳特	Bennett
斑马火锅店	Zebra Hot Pot Restaurant
茶室	tea room
店长	manager
师祖	Grandmaster
点石成金	Midas Touch
桂皮	cinnamon
香菜	cilantro
‘班’	"Ben"
茶楼	tea house
妓院	brothel
伯顿	Borg
情报部	intelligence department
地窖	cellar
期末晚会	term-end party
煤炭	coal
密道	secret passageway
蒸汽时代。	Age of Steam
环保局	Environmental Protection Agency
环保部门	Environmental Protection Agency
纺织行业	textile industry
纺织厂	textile factory
精灵公主	elven princess
精灵女王	elven queen
雷暴山脉	Thunderstorm Mountains
邪灵	evil spirit
部下	subordinate
后裔	descendent
邪神	Evil God
羊皮纸	parchment
布莱兹	Blaze
大队长	captain
布雷兹	Blaze
触须	tentacle
铁板鱿鱼	teppan grill squid
巡查司	Inspection Troop
手下	subordinate
火锅店	hot pot restaurant
后备司	reserve division
石头巷	Stone Alley
西姆酒馆	Sim Tavern
西姆	Sim
茅台	Maotai
鹰	eagle
奥斯特	Auster
海曼	Heyman
一号厨房	Kitchen One
奥格部落	Aug Tribe
朗姆酒	rum
天神兽	heavenly beast
老西姆	Old Sim
杰勒米	Jeremy
组织	organization
姑娘	maiden
酿酒师	brewer
大厨房	main kitchen
裴迪南	Ferdinand
肯恩	Kernen
话痨水	talkative water
内城	inner city
线人	informant
前任酋长	former chief
加封仪式	conferring ceremony
迷醉剂	confounding drug
魔法活性降低药剂	magical activity lowering drug
德沃德	Durward
老酋长	old chief
弑君者	Kingslayer
猎豹	cheetah
巴兹尔	Basil
达里尔	Darryl
库尔特	Kurt
裴迪南公子	Young Master Ferdinand
舅舅	uncle
舅妈	auntie
噬元兽神	Flerken
罗密欧	Romeo
茱丽叶	Juliet
铭文	inscription
海鳗鱼叔叔	Uncle Crayman
宫殿	palace
小火莲	Little Fire Lotus
对讲机	walkie-talkie
随身蝙蝠	personal bat
祖母	grandma
日记	diary
厄巴部落	Urba Tribe
长刀	long sabre
无奈	reluctant
各单位注意	Attention, all units
宫女	palace maid
阵法师	formation master
钮钴禄	Niohuru
冰封领域	Ice Seal Domain
伊里	Yiri
特使	special envoy
艾赛亚	Isaiah
噬元兽	Flerken
青空部落	Blue Sky Tribe
特坦	Tetan Tribe
嘎啦部落	Gala Tribe
头孢	cephalosporin
代表团	delegation
绞刑架	gallow
火烈鸟	flamingo
国字脸	square-faced
比利	Billy
酒神	Goddess of Wine
耳机	headset
黄焖鸡	braised chicken
青空酋长	Blue Sky Chief
公子	Young Master
产权部	Department of Property Rights
石匣	stone box
变脸面具	face-altering mask
房产证	property deed
约拿	Jonah
酿造室	brewing room
机械师	mechanic
自然女神	Goddess of Nature
金甲雕	Golden Armored Condor
葫芦	gourd
建筑师	architect
织布机	loom
酿造机	brewing machine
酿酒机	brewing machine
老卡尔	Old Carl
说书	storytelling
老西姆牌	Old Sim's
卡鲁	Karoo
魔法师大会	Magic Caster Tournament
二皇子	Second Prince
大皇子	First Prince
影卫	shadow guard
莫里斯	Maurice
洛伦佐	Lorenzo
紫晶巨龙	purple crystal dragon
尤斯塔斯	Eustace
暴王龙	Tyranno Dragon
路易斯	Louis
酒厂	brewery
多米尼克	Dominic
鸳鸯锅	double-flavored pot
咔哒果	Kada
油炸知了猴	deep-fried cicadidae
豆汁	fermented soya-bean milk
仰望星空	stargazy pie
鲱鱼罐头	surströmming
烤蛾子	roasted moth
烤猪眼	roasted pig's eyes
密集恐惧症	trypophobia
超级融合菜谱	super fusion recipe
百变面具	face-altering mask
旧日支配者	Great Old Ones
末日支配者	Great Old Ones
裁定书	official ruling
麦瑞火锅	Mana Hot Pot Restaurant
猪眼	pig's eyes
母后	Royal Mother
达伦	Darren
露西	Lucy
阿马里山	Mount Amari
阿道弗斯	Adolphus
雪橇	snow sledge
克里斯托弗	Christopher
老花眼	presbyopia
老账房	old accountant
账本	ledger
艾伯特金铺	Abbott Jewellery Store
凯斯琳	Kathleen
T血清	Serum T
老先生	Old Sir
多萝西	Dorothy
贾森	Jason
克里斯托弗先生	Mr. Christopher
近视眼	myopia
烈火野猪	Fiery Wild Boar
阿道弗斯大夫	Dr. Adolphus
种族大会	racial meeting
员工	employee
生命丸	Pill of Life
钱箱	money box
吉布森	Gibson
血兽	Blood Beast
孙女	granddaughter
祖父	Grandfather
魅族之王	Sovereign of the Succubi
吸血鬼之王	Sovereign of the Vampires
莫妮卡	Monica
兵器排行榜	Weapons' Ranking
锻造协会	Forging Association
麦格·亚历克斯	Mag Alex
天女	holy maiden
小艾米	Little Amy
魔法棒	magic wand
兵器	weapon
羊肉汤	mutton soup
羊粪	sheep's dung
卡西亚	Cassia
掌柜	manager
安尼塔	Anita
蓝胖胖	Blue Fatty
卡西亚火锅店	Cassia Hot Pot Restaurant
买一送一	buy one get one free
麻辣牛肉	Mala spicy beef
艾萨克	Isaac
永远长眠的未必是死亡	That is not dead which can eternal lie
章鱼怪	octopus monster
储物戒	storage ring
检验报告	inspection report
篝火	bonfire
权杖	Scepter
祭司	priest
眉心	glabella
情报处	Informations department
空洞	void
封印之地	sealed land
魔气	evil aura
刘易斯	Louis
蓝蓝草原	Blue Grassland
蓝银草	Silver Blue Grass
铁头鹰	Iron Head Eagle
极地	Polar Black Goat
牧民	herders
山羊	goat
伊迪	Eddie
草原	grassland
雪山	snow mountain
烤羊肉	roast mutton
巴克部落	Buck Tribe
膻味	rank odor
羊奶	sheep's milk
黑山羊	black goat
阿方索	Alfonso
红柳烤肉	Roasted mutton cubes on rose willow branch
巴卡木	Baka Tree
西北极寒之地	extreme cold place in the northwestern area
烤全羊	whole roasted goat
干蘸碟	spicy powder dip
干碟	dry seasoning
少年组	youth category
羊肉串	mutton kebab
莱顿	Leiden
穆尔	Moore
羊肉馆子	mutton restaurant
炖羊肉	mutton stew
检测报告	test report
章鱼须	octopus tentacle
加工厂	processing plant
设定	setting
巴卡拉家族	Bakra Family
神祇	god
吐槽	diss
阿维娃	Aviva
赫蒂	Herty
赫妮	Herny
符文	runes
家仆	servant
啤酒	beer
销售链	sales chain
销售链	distribution chain
匹	bolt
销售团队	sales team
产能	output
女王之书	Book of the Queen
诸神之战	War of the Gods
月亮之泪	Tear of the Moon
无尽深渊	Boundless Abyss
地宫	underground palace
和平协议	peace accord
古籍	old book
古籍	ancient books
藏书阁	library
闭门会议	closed-door meeting
厂长	director
财务	finance department
各族代表大会	Racial Meeting
二皇兄	Second Royal Brother
城西坊市	west city square
莱姆羊肉馆	Leimo Mutton Restaurant
彦	Yan
铁轨	railway
钢铁巨兽	steel giant
烤生蚝	grilled oyster
先遣部队	Advanced Force
各族代表	various representatives
法兰克林	Franklin
代表	representative
感知	perception
魔气	evil aura
壁画	mural
心有余悸	lingering fear
不可名状物	indescribable thing
斗地主	Peasants vs Landlord
富兰克林	Franklin
冰霜领域	Frost Domain
肯尼斯	Kenneth
烤牛肉串	roast beef kebab
琼纳斯	Jonas
空间魔法	spatial magic
解析	decipher
爱德华	Edward
材料	material
血精石	Bloodstone
雷劫	thunderstrike
巴菲特庄园	Buffett Manor
摩尔顿庄园	Moreton Manor
族长	head of the family
莫尔顿家族	Moreton Family
甜脆饼	pancake
神识	consciousness
丹妮斯	Denise
莫尔顿庄园	Moreton Manor
风暴巨龙	Storm Dragon
考辛斯	Cousins
触手	tentacle
冰凤	ice phoenix
火龙	fire dragon
劫云	ordeal cloud
雷电	lightning
恐怖恶魔	Fear Demon
紫金	golden-purple
章鱼哥	Bro Octopus
雷劫	ordeal lightning
章鱼	octopus
安妮	Annie
爆炒章鱼须	Stir-fry octopus tentacles
章鱼小丸子	octopus ball
章鱼刺身	octopus sashimi
酱拌八爪鱼	marinated octopus
小米	Little Amy
深海权杖	Scepter of the Deep Sea
威士忌	whiskey
憨	bashful
鲜味	umami
沙拉酱	mayonnaise
木鱼花	bonito flakes
海苔丝	shredded seaweed
奥黛丽	Audrey
天道法则	Law of the Way
美食大会	Delicacy Extravaganza
贝蒂	Betty
识海	knowledge storage
香岛	Fragrant Island
香香鹿	Fragrant Deer
半神	demi-god
飞剑	flying sword
法玛·奥丁·本	Fama Odin Ben
哑症	mutism
广袤	vast
海鲜铺	seafood shop
艾丽娅	Alia
代理店长	acting manager
货梯	freight elevator
冷库	cold storage
除冰机	deicer
小系海鲜铺	Little Sys Seafood Shop
限定新品	limited edition new products
阿尔宾	Albin
紫金魔石	golden-purple magic stone
投影巨幕	Giant projection screen
鸡腿	drumstick
富勒家族	Fuller Family
法师组	magic caster category
选手	contestant
对手	opponent
土系魔法	earth magic
号码牌	number tag
贾斯伯	Jasper
徒儿	disciple
会场	exhibition hall
阿瓦尔	Alva
大金牙	Big Gold Teeth
一份	one helping
两份	two helpings
一份	a helping
烤羊排	roasted mutton ribs
观星楼	Star Observatory Center
子爵	Viscount
麦金利	McKinley
火墙	firewall
陨石	meteorite
陨星坠落	Meteorites Falling
陨星	meteorite
高阶魔法	advanced magic
玛吉	Maggie
奥尔登	Aulden
科利尔	Collier
排位赛	qualifying match
雷电魔法	Lightning magic
酱爆章鱼须	stir-fry octopus in XO sauce
电网	electrical net
十长老	10th Elder
冰盾	Ice shield
中级魔法师	intermediate magic caster
冰遁	Ice Escape
冰火莲花	ice and fire lotus
章鱼须刺身	octopus tentacle sashimi
刺身	sashimi
水柱	waterspout
亚伯罕公爵	Duke Abraham
无限水遁	Infinite Water Escape
斯玛	Smore
斯玛脆饼	Smore Pancakes
萤火虫谷	Firefly Valley
萤火虫	firefly
乌迪尔	Udyr
麻婆豆腐	Mapo Tofu
美食启蒙者	Gourmet Enlightener
信徒	believer
飞行堡垒	flying fortress
投影石	Projectorstone
转换阵法	transformation spell formation
魔视机	Magicvision
奖杯	trophy
火焰领域	Flame Domain
天空之岛	Isle of Skye
皮划艇	canoe
DVD	DVD
水道	waterway
黄金龙岛	Golden Dragon Island
钟乳石	stalactite
探照灯	searchlight
冰霜令	Frost Order
塔兰丛林	Taran Forest
雅布湖	Jab Lake
长老	Elder
十大龙族	top ten dragon tribe
大厨师	Master Chef
希望学园	Hope School
塔西尔	Tahirid
比琳达	Berlinda
杰里迈亚	Jeremiah
乔治娜	Georgina
西特巷	Sitter Alley
卡卡西老	Teacher Kakashi
月亮石	moon stone
加兰	Garlan
迈洛	Mylo
主编	Chief Editor
五花肉	pork belly
劲装	action suit
皮货商人	skin trader
牛肉卷	beef roll
羊肉卷	mutton roll
塔西拉姆	Taslem
布鲁诺	Bruno
和平联盟	Peace Alliance
驭兽师	beast tamer
死灵骑兵	undead troops
叛徒	betrayer
以赛亚	Isaiah
乌托	Uto
泰斯尔	Taizer
西拉	Sila
巴罗	Barlo
查利	Charlie
凯因斯	Keynes
拉德纳	Lardnar
施塔特	Statt
夹克	jacket
美食教程的专栏	gourmet tutorial column
美食教程专栏	gourmet tutorial column
专栏	column
美食教程	cooking tutorial
粉丝	fan
夜行衣	night camouflage clothes
黑衣人	black-robed figures
传说之境	realm of legend
女儿	daughter
铁骑	cavalry
亚历克斯大人	Lord Alex
布鲁诺	Bruno
黑猩猩	chimpanzee
金刚猿	King Kong Ape
石棒	stone club
降神棒	Seance Club
铁木	ironwood
西北	northwestern
军区	military zone
和平联盟	peace alliance
烧鹅	Roast goose
和平大会	peace meeting
丹顿	Denton
西北联军	northwestern allied forces
乌托部落	Uto Tribe
任务点	mission points
怨气	resentment
伊曼	Iman
生命之城	City of Life
卡图尔	Katur
巴顿	Patton
嗜血犀牛	Bloodthirsty Rhinos
铁背鹰飞行团	steel eagle troop
铁背鹰	steel eagle
精灵	elven
精灵	elves
西卡拉	Sicarra
嘎嘎	Gaga
甄福妮	Genevieve
大妈家	Big Momma
辣酱	spicy sauce
鹅	goose
信仰点	religious points
酸梅酱	plum sauce
诺亚	Noah
梅兰特	Merante
龟甲石	septaria oracle
龟甲	tortoise shell
龟壳	tortoise shell
竹竿	bamboo rod
鬼族	Ghost Clan
至纯者	purest
精血	blood essence
主教	bishop
种族战争	racial war
薇薇安老师	Teacher Vivian
主教大人	Lord Bishop
希利	Seely
教皇	pope
教士	missionary
教会	church
大主教	archbishop
神女	Holy Maiden
教廷	Holy See
神灵	Holy Spirit
卡诺	Canault
奇拉部落	Kila Tribe
霍克部落	Hulk Tribe
神力	divine power
福利院	orphanage
安奈林	Aneurin
和平派	pro-peace factions
凉拌猪耳朵	pig ears salad
秘制酒鬼花生	secret drunkard peanuts
埃菲	Eiffie
酒鬼花生	drunkard peanuts
塞班酒馆	Saipan Tavern
凉拌猪舌	pig tongue salad
波比	Bobby
泰坦酒馆	Titan Tavern
大将军	Great General
布卢姆	Blum
铁锅炖大鹅	Stewed Goose In Steel Pot
兰贝街	Lambay Street
罗莫街	Romo Street
费奇	Fitch
哈迪斯先生	Mr. Hades
泰坦酒馆	Titan Tavern
塞班	Saipan
塞班酒馆	Saipan Tavern
凉拌猪舌头	pig tongue salad
信仰之力	power of faith
兵部	Ministry of Defense
塔克坊市	Tuck Square
鹅	geese
小吃	snacks
伊斯牛肉馆	Iss Beef Restaurant
牛肉馆	beef restaurant
卢西恩	Lucien
赫克托	Hector
初级甜品师	Junior Patissier
大礼包	gift package
红豆糕	red bean cake
双皮奶	milk custard
芒果班戟	mango pancake
蛋黄酥	Salted Egg Yolk Pastry
利尔	Lear
甜点师	patissier
绿豆酥	mung bean pastry
绿豆糕	mung bean cake
绿豆	mung bean
卡托拉	Cataula
帕萨	Pasa
御书房	Royal Study
陛下	His Majesty
官员	officials
克莱拉	Clara
书店	bookshop
书坊	book square
信仰值	faith value
画册	picture album
法部	Ministry of Law
画册	picture book
话本	storybook
胖爷爷	Fat grandpa
手语	sign language
中华小当家	Cooking Master Boy
擀面杖	roller pin
小弟弟	Little Brother
生活体验系统	Life Experience System
生活体验值	life experience points
灌汤包	soup dumpling
刀削面	shaved noodles
热干面	Hot Noodles with Sesame Paste
面食	cooked wheaten food
小王子	little prince
漫画家	comic artist
体验值	experience points
新手任务	novice assignment
笑话大王	The King of Jokes
属性鉴定	Attribute Identification
红油抄手	Sichuan spicy wontons in red oil
抄手	wonton
拍黄瓜	Smashed Cucumber Salad
料汁	flavoring sauce
金瓶梅	The Plum in the Golden Vase
皮冻	frozen soup
蟹黄灌汤包	crab roe soup dumpling
品酒大会	liquor tasting
金奖	gold award
酒窖	cellar
泰坦酒	Titan Liquor
小丫鬟	little maid
小家伙	little one
玛拉	Mala
画本	picture book
核动力	nuclear-powered
印刷机	printing machine
观察者日志	Observer's Diary
拉莱耶	R'lyeh
事件评估	Situation Evaluation
天空岛	Sky Isle
未知	Unknown
胜算	odds
晞	Xi
观察者	Observer
装备仓	equipment bay
古大陆	ancient continent
新住民	new inhabitant
高级文明	advanced civilization
营养膏	nutritional cream
空间通道	space passage
代号：9527	Codename: 9527
高等文明	advanced civilization
蒸馏设备	distillation equipment
机械	machinery
糊涂汤	cucumber soup
重狙	bullpup assault rifle
古老者	Elder Things
入侵者	invaders
重狙	assault rifle
外来文明	alien civilization
地下城	Underground City
早餐店	breakfast shop
飞船	spaceship
追踪器	tracking device
奥特曼	Ultraman
巨蛇	giant snake
千层饼	thousand layer cake
摩托	motorcycle
五百里	800 km
三头蛇	three-headed snake
恐怖猎手	Horror Hunter
仆从	servant
仆从种族	servant race
通讯器	communicator
地下世界	Underground World
男爵	Baron
美酒协会	Wine and Liquor Association
弗格斯	Fergus
品酒师	sommelier
巴拉卡	Baraca
果酒	ratafia
教堂	church
里斯酒馆	Reese Tavern
爆炸酒	Explosive Liquor
银奖	silver award
鲍里斯	Boris
酒量	alcohol tolerance
马库斯	Marcus
杰拉	Gerald
酒香	liquor's aroma
粮食酒	grain alcohol
卡莎酒馆	Casa Tavern
麦德勋	Madison
香辣田螺	spicy escargot
田螺	escargot
冰崖	ice cliff
古尸	ancient corpse
尸体	corpse
人面蛛	giant woods spider
飓风	hurricane
电磁炮	electromagnetic gun
战舰	battleship
紧身衣	body suit
虚拟屏	virtual screen
丧尸	zombie
亡灵军团	Army of the Dead
亡灵	dead souls
星际战舰	starship
星际战舰	intergalactical battleship
火炮	cannon
丧尸军团	zombie army
橡木桶	oak barrel
抵抗联盟	Resistance Alliance
帕萨卡	Pasaca
萝卜条	preserved radish strip
乔	Joe
安东	Anton
乔	Joe
领地	fiefdom
奴隶圈	slaves' circle
德克	Dirk
暴徒	assailant
卡巴斯	Kabas
凶手	perpetrator
衙门	court
山猫	lynx
土狗	Mutt
蜗牛	snail
玛瑙蜗牛	Achatinella
法国蜗牛	French escargots
灰岩蜗牛	Grey Rock Snail
小美人鱼	little mermaid
一百里	160km
总酋长	Chieftain
许愿井	wishing well
大反派系统	Villain System
辣条	spicy strip
黄金大殿	Golden Hall
群岛	archipelago
琼斯	Jones
工作服	uniform
黑猫歌剧院	Black Cat Opera House
剧院	opera house
歌剧	opera
帕斯卡	Pascal
团长	Maestro
黑猫歌剧团	Black Cat Opera
马卡歌剧团	Maca Opera
薇琪	Vicki
薇琪团长	Maestro Vicki
歌剧团	opera troupe
团员	troupe member
黑猫小姐	Miss Black Cat
早餐	breakfast
蒸屉	steamer
博比	Bobby
大酋长	chieftain
西北军团	Northwestern Legion
最高指挥官	supreme commander
联盟	alliance
军团	legion
副指挥官	deputy commander
森林	forest
战术预案	tactical plan
马戏剧院	Circus Theater
剧院	theater
101号楼	Building 101
老四	Four
阿宝	Bao
沙盘	scenario table
千层饼	mille crepe
康帝	Conti
炮弹	artillery shell
阵法加持	Spell formation enhancements
炸膛	chamber blow
骷髅士兵	skeleton soldier
朱砂	cinnabar
弩	crossbow
箭头	arrowhead
木箭	wooden arrow
杀伤力	lethality
糯米	glutinous rice
骷髅兵	skeleton soldier
九叔	Uncle Nine
五十里	80 km
圣水	Holy Water
杀伤	lethal
联络人	liaisons
桃木	peach wood
桃木箭	peach wood arrow
桃木剑	peach wood sword
联络官	liaison
桃树	peach tree
集结	assemble
征召令	summoning order
格斯山脉	Gus Mountains
山脉	mountain range
工兵团	engineer corp
冰原	ice sheets
修筑工事	construct defenses
工兵	sapper
豁口	gap
天堑	natural chasm
风系魔法师	wind magic caster
水系魔法师	water magic caster
冰系魔法师	ice magic caster
战线	battle line
战线	battle front
泄洪通道	flood-relief channel
防洪提	flood dike
峡谷	canyon
峡谷	ravine
临时指挥部	interim command
军官	officer
大殿	great hall
营地	base
议事厅	meeting room
生命之乳	Milk of Life
胖头鱼	"Fat Head Fish"
星之眷族	Star-Spawn of Cthulhu
尸龙	zombie dragon
冰枪	ice javelin
光系魔法师	light magic caster
风龙	Wind Dragon
空间储存器	spatial storage equipment
空间储物器	spatial storage equipment
炮弹	ammunition
朱砂粉	cinnabar power
通天柱	infinity column
门票	ticket
邻居	neighbor
街坊	neighbor
演员	actor
伊巴卡	Ibaka
罗斯福	Roosevelt
情报驿站	intel center
远古入侵者	ancient invader
战机	fighter jet
武器操作系统	weapon operating system
追踪导弹	homing missile
武器仓	weapons bay
机甲	mech
弯刀	scimitar
枪口	muzzle
蘑菇云	mushroom cloud
自爆程序	self-destruction program
穿甲弹	armour-piercing projectile
推进器	thruster
近防炮	Close-In Weapon System
灰色战舰	gray battleship
神级	god's tier
附魔	enchanted
空间箱子	spatial box
舰长	captain
黑猫号	"Black Cat"
费迪南德	Ferdinand
费迪南德先生	Mr. Ferdinand
爷爷	grandfather
委托令	power of attorney
联防军	Allied Defence Force
费迪南德大人	Lord Ferdinand
自爆	self-detonation
第一舰队	First Fleet
晞舰长	Captain Xi
薇琪小姐	Miss Vicki
紫色闪电	purple lightning
神境	god's realm
瘴气	miasma
十里	16 km
第二炮兵团	Second Artillery Regiment
拉莱耶城	R'lyeh City
麦克瑞	Macron
空中幽灵	Air Spirits
骨龙	skeleton dragon
幽光	Dark Light
火凤	fire phoenix
前线	frontline
炸药包	blasting charge
投石器	catapult
绞肉机	meat grinder
雪狐	snow fox
兵工厂	weapon factory
驴	donkey
坐骑	steed
晞姐	Big Sister Xi
征服者	Conquerers
连弩	repeater crossbow
医疗兵	Medic
冰川	glacier
炮兵	artilleryman
热兵器	firearms
慕斯蛋糕	mousse cake
阿尔瓦撒	Arwassa
哈斯塔	Hastur
天罚	Heaven's Punishment
地球	Earth
大哥	Big Brother
冰霜龙岛	Frost Dragon Island
冰霜王座	Frost Throne
米老头	Old Man Mi
小白	Whitie
红烧牛肉	red braised beef
小美人鱼的故事	The Tale of The Little Mermaid
绘本	picture book
黑白绘本	black-and-white picture book
黑白	black-and-white
世界	world
莫莉	Molly
夏娃	Eve
骨汤	bone broth
面皮	dough skin
烤鸭	roasted duck
漫画	comic
教程	tutorial
编辑社	editorial agency
独家专栏	exclusive column
独家	exclusive
美食专栏	gourmet column
美食教学	culinary tutorial
卡姿兰	Carslan
阿莉斯	Alice
王子	prince
卡姿然	Carslan
冰糖葫芦	candied haws
茶馆	teahouse
折叠椅	folding chair
猪舌头	pig tongue
猪舌	pig tongue
服务员	server
洛丽塔	Lolita
版权	copyright
授权收益	licensing revenue
授权	licensing
反响	repercussions
博卡	Bobby
后台	backstage
演出服	costume
金主	sponsor
舔狗	bootlicker
票	ticket
笨蛋系统	Stupid System
邻里关系	neighborly relationship
好感度	Favorability
小七	Little Seven
合同	contract
编辑部	editorial department
郝克托	Hector
彩色绘本	colored picture book
彩绘	colored picture book
彩印	color printing
财富密码	secret of wealth
纸媒	paper media
黑板	blackboard
辣子鸡	Sichuan spicy chicken
抄手皮	wonton skin
胃	stomach
高脚凳	barstool
核能	nuclear-powered
太子	crown prince
降维打击	dimensionality reduction attack
天才	genius
超凡者	Extraordinaire
通讯栏	notification column
尤妮斯	Eunice
希望小学	Hope Primary School
尤妮斯夫人	Lady Eunice
辣椒	chili
鸡	chicken
公筷	serving chopsticks
郝克托老板	Boss Hector
印刷工厂	printing factory
印刷厂	printing house
办公室	office
药剂瓶	medicinal vial
减肥药剂	slimming drug
技术	technology
技术	technique
海神珠	Magical Pearl of the Sea
海神	God of Sea
水晶球	crystal ball
特菲娜	Tryphaena
辛德拉	Syndra
职业技能老师	professional skills teacher
希拉	Hera
梅丽	Meli
埃尔顿	Elton
观众	audience
牙签	toothpick
麻辣田螺	Spicy Escargots
克利夫兰	Cleveland
冰激凌店	ice cream shop
姐姐	Sister
新东方厨师学院	New East Culinary School
厨师学院	culinary school
师培养基地	chef-grooming ground
工程队	construction team
金目白虎	Golden-Eyed White Tiger
妖核	phantom core
丹尼斯	Dennis
团长	Captain
猴子	Monkey
斑纹魂豹	Striped Soul Leopard
魂豹	soul leopard
西红柿蛋汤	tomato and egg soup
蛋花汤	egg drop soup
铁背狂牛	Iron-back Bull
荆棘丛	Thorny Shrub
西红柿鸡蛋汤	tomato and egg soup
神秘空间节点	Mysterious Space Node
魅魔互助协会	Succubi Support Association
电影	Movie
倩女幽魂	A Chinese Ghost Story
权游	Game of Thrones
魅魔	succubi
安小倩	An Xiaoqian
中校	Commander
分子料理	molecular gastronomy
米饭	rice
银河舰队	Galácticos
亚历克斯先生	Mr. Alex
山姆	Sam
狂化药剂	Madness Potion
卡马洛	Camaro
药剂师	pharmacist
佣兵团	mercenary squad
窜天猴	sky monkey
机械学院	Machinery College
校长	principal
发声器	acoustic generator
实训中心	training center
灶台	cooktop
麦格老师	Teacher Mag
厨师实训中心	Chef's Training Center
老师	teacher
露娜校长	Principal Luna
纸袋	paper bag
泳装	swimsuit
泳衣	swimsuit
豹纹泳装	leopard print swimsuit
大黄鱼	large yellow croaker
清蒸大黄鱼	steamed large yellow croaker
碳烤生蚝	charcoal-grilled oyster
蒜蓉粉丝蒸扇贝	scallops with minced garlic and bean vermicelli
红烧青蟹	red braised blue crab
海带	seaweed
扇贝	scallop
切莉	Cherie
伊妮	Eni
安圣岛	Anson Island
卡罗德	Carrod
菲彼得	Field
拜伦	Byron
德里克	Derek
空间裂缝	spatial interstice
遗迹	traces
传承	legacy
潜水艇	submarine
大理石	marble
裂缝	crack
裂缝	interstice
小乖	Kiddo
卵生哺乳	Oviparous
妹妹	younger sister
妹妹	little sister
炒饭	fried rice
写生	sketch
吸血鬼岛	Vampire Island
中级诅咒魔法	intermediate cursing spell
诅咒魔法	cursing spell
减肥茶	slimming tea
钱袋	money bag
黑蛤蟆	Black Toad
卡罗琳	Caroline
卡罗琳阿姨	Auntie Caroline
辛西娅	Cynthia
老板娘	Lady Boss
西北孤狼	Northwestern Lone Wolf
小辛	Cyn
减肥果汁	slimming fruit juice
魔影	Magvie
代理权	dealership
电影院	cinema
光影	holographic
拍摄设备	shooting equipment
播放设备	playback device
设备	equipment
播放器	player
剧本	script
编剧	scriptwriter
分镜	storyboard
春笋炒肉片	stir-fried pork with spring bamboo shoots
树妖	dryad
脑机接口	brain-computer interface
脑机	brain-computer interface
天马行空	blue-sky thinking
麦老板的不伦小娇妻	Boss Mag's Indecent Little Wife
稿酬	remuneration
签售会	book signing session
被和谐	censored
德尔玛	Delmar
小H	smut
帕达尔	Padar
出版社	publishing house
稿费	remuneration
同人小说	fan fiction
蓝特出版社	Randt Publishing House
发行使用费	Issue royalties
笑得合不拢嘴	grin from ear to ear
同行	peers
制式合同	standard contract
担保人	guarantor
敷衍	perfunctory
先生	Mr.
麦老板与黛蓝老板娘不可告人秘密	Boss Mag And Blue Suede's Lady Boss' Dirty Little Secret
合约	contract
精神系魔法师	spiritual magic caster
小小老板	Tiny Boss
杀气	murderous intent
神秘奖励	Mysterious reward
黑粉	Anti-fan
布西街	Boosey Street
围挡	hoarding
麦米广场	Mamy Square
商业中心	commercial center
麦米影城	Mamy Cineplex
影城	cineplex
商城	mall
植物系魔法师	botany magic casters
建工地	construction site
工地	construction site
小说作者	novelist
小说	novel
德尔玛出版社	Delmar Publishing House
女编辑	female editor
奥罗拉	Aurora
洗浴中心	bathhouse
埃莉诺	Eleanor
作者	author
麦米出版社	Mamy Publishing House
魅魔情缘	Love Of A Succubus
副主编	deputy chief editor
实践课程	practical course
麦老师	Teacher Mag
助教	teaching assistant
课程表	timetable
孩子	children
教学楼	teaching building
希拉老师	Teacher Hera
贝克	Beck
厨师	chef
厨师	cook
厨神进阶班	God of Cookery's Advanced Class
铁锅	metal pot
法拉	Farah
半兽人	half-orc
食堂	canteen
学号	Student Number
讲台	lectern
实训	practical course
教师	teacher
大楼	building
学生	student
贵妇	wealthy ladies
蛋糕	Cake
芒果慕斯蛋糕	mango mousse cake
芒果	mango
芒果慕斯	Mango Mousse
提拉米苏	tiramisu
月考	monthly test
梅丽老师	Teacher Meli
抹茶慕斯	Matcha mousse
姜丝	shredded ginger
进阶班	Advanced Class
出来吧!	Manifest!
冰箭	ice arrow
神器	artifact
回去吧！	Go back!
阿尔瓦	Alva
卖米餐厅	Mami Restaurant
孙悟空三打白骨精	Monkey Subdues White-Skeleton Demon
西游记	Journey to the West
孙悟空	Monkey
唐僧	Tripitaka
白虎岭	White Tiger Ridge
唐三藏	Tripitaka
女主	female lead
秘穴魅影	Phantom of the Secret Cave
男主角	male lead
克莱得	Clyde
酸辣土豆丝	Hot and sour shredded potato
伊莎	Issa
椒盐土豆	Salt & Pepper Potatoes
土豆丝	shredded potatoes
基石	cornerstone
小猪	piglet
猪	pig
黑铁卫	Black Queensguard
女王	Queen
登基	ascension
加冕	coronation
加冕大典	coronation ceremony
加冕典礼	coronation ceremony
令牌	token
班奈特	Bennett
白玉阶梯	white jade stairs
白玉祭坛	white jade altar
石碑	stele
神格	divinity
传音	telepathically
传声	telepathically
神婴	holy infant
女婴	baby girl
摇篮	cradle
金属舱	metal pod
舱	pod
怪物	monster
陛下	Her Majesty
母皇	Royal Mother
核心	nuclear core
金属仓	metal pod
藤	vine
孩子	child
机关术	mechanism
越界者	trespasser
执法队	law enforcement team
上校	Colonel
文明	civilization
编年史	chronicle
羊奶	goat's milk
芽衣	Yayi
芽衣小妹妹	Little Sister Yayi
芽衣妹妹	Little Sister Yayi
小芽衣	Little Yayi
财阀	plutocrat
分析报告	analysis report
分析报告	analysis report
核心	core
五大	Big Five
技术人员	Technical staff
不死者	Immortel
技术部	Technical Department
越境者	trespassers
石柱	stone pillar
长矛	spear
嘤	ouin
超凡	Extraordinaire
米娅老师	Teacher Miya
削皮	peel
皮特	Pete
标杆	benchmark
工艺	workmanship
航母	aircraft carrier
五十亿	5,000,000,000
三十亿	3,000,000,000
生产链	supply chain
十五亿	1,500,000,000
领地	territory
半步超凡	Almost-Extraordinaire
下属	subordinate
配菜	side ingredients
铁路	railroad
思想家	philosopher
美食	Gourmet
半超凡	Almost-Extraordinaire
军方	military
联邦	Federation
手环	bangle
身份手环	identity bangle
黑曜石	obsidian
雷电珠	Thunderball
密匙	cryptographic key
雷鸣舰	Thunder Ship
单人作战	solo combat
神碑	sacred stele
神秘	mysterious
地下城联邦	Underground City Federation
政治体系	political system
总统	president
第一元帅	First Marshal
麦卡锡	McCarthy
麦卡锡家族	McCarthy Family
塔姆议员	Congressman Tamm
阿曼德	Armand
参悟	comprehend
富贵险中求	money comes from danger
嘤	Wah
工程部	engineering department
载人列车	passenger train
总工	chief engineer
战服	combat suit
保温盒	insulated box
官方语言	official language
飞车	flying car
油门	accelerator
仪表盘	instrument panel
时速	speed
普通话	common speech
通用语	Common language
影视库	video library
防撞	collision avoidance
狙击枪	sniper rifle
枪械	guns
枪械库	armory
武器库	armory
加特林	Gatling
教练	Coach
好评榜	top-rated list
倾国绝恋	Desperate Love
男主	male lead
膀胱	bladder
动漫	anime
二十四亿	24,000,000
哈迪斯·塞班	Hades Saipan
照片	photograph
灵感	inspiration
蒸汽朋克	steampunk
哪吒	Nezha
陈塘关	Chentang Pass
四海龙王	Four Dragon Kings of the Sea
厨王争霸赛	Top Chef Competition
塔克城	Tucker City
综艺节目	variety show
摩卡集团	Mocha Group
比赛	competition
厨神争霸赛	Top Chef Competition
界面	interface
功能	function
贾斯珀．弗拉格	Jasper Flagg
弗拉格	Flagg
节目组	programming division
神秘嘉宾	mysterious guest
热搜	trending
微推	WeTwit
网络	internet
导演	director
大v	influencer
贾斯伯·弗拉格	Jasper Flagg
热搜榜	trending list
一百八十亿	18,000,000,000
双塔大厦	Twin Towers
狄克逊家族	Dixon Family
十大家族	Top Ten Families
信息	message
线上人气	online popularity
专业厨师组	professional chefs' team
练习生	intern
娱乐公司	entertainment company
网络人气	online popularity
人气	popularity
八强赛	quarterfinal
四强赛	semifinal
决赛	final
饭圈	fandom
娱乐圈	entertainment industry
巴特	Bart
霍勒斯	Horace
